Game Name,TA,GS,TAD,Num,Time,Score
while True: learn(),2687,1000,1687,28,8.0,5904.5
to a T,3752,1000,2752,33,15.0,6054.4
theHunter: Call of the Wild (Windows),8423,1000,7423,48,204.0,1746.5882352941176
ilomilo plus (Windows),477,200,277,20,15.0,369.3333333333333
iStunt 2 (Windows),480,200,280,20,8.0,700.0
iO The Game (Windows),483,200,283,20,6.0,943.3333333333334
eFootball,1680,1000,680,17,1.0,11560.0
art of rally,3897,1000,2897,43,20.0,6228.55
Zoo Tycoon: Ultimate Animal Collection,11556,1500,10056,59,80.0,7416.3
Zombies!!! (Windows),269,200,69,12,3.0,276.0
Zombie Rollerz: Pinball Heroes,5444,1000,4444,73,145.0,2237.3241379310343
Zombie Hill Racing,1781,1000,781,14,12.0,911.1666666666666
Zombie Derby: Pixel Survival (Windows),5348,5000,348,30,0.5,20880.0
Zombie Derby 2 (Windows),5494,5000,494,30,0.5,29640.0
Zombie Derby (Windows),5493,5000,493,30,0.5,29580.0
Zombie Army 4: Dead War,3728,1100,2628,59,41.5,3736.1927710843374
Zoffice (Windows),1004,1000,4,10,0.5,80.0
Ziggy (Windows),10290,4000,6290,38,0.5,478040.0
Zeus Quest - The Rebirth of Earth,1187,1000,187,26,1.0,4862.0
Zero Escape: Zero Time Dilemma,1217,1000,217,33,20.0,358.05
Zero Escape: The Nonary Games,1484,1000,484,38,40.0,459.8
ZERO GUNNER 2-,3020,1000,2020,30,7.0,8657.142857142857
Your Computer Might Be At Risk,1831,1000,831,37,7.0,4392.428571428572
Young Souls,2800,1000,1800,33,6.0,9900.0
You Suck at Parking,10507,1325,9182,25,44.0,5217.045454545455
Yooperlite (Windows),2016,2000,16,15,0.5,480.0
Yooka-Laylee and the Impossible Lair (Windows),2273,1000,1273,47,20.0,2991.55
Yooka-Laylee (Windows),1590,1000,590,35,20.0,1032.5
Yonder: The Cloud Catcher Chronicles,1846,1000,846,38,20.0,1607.4
"Yes, Your Grace",2295,1000,1295,35,12.0,3777.0833333333335
Yakuza: Like a Dragon,2054,1000,1054,62,80.0,816.85
Yakuza Kiwami 2 (Windows),2238,1000,1238,59,60.0,1217.3666666666666
Yakuza Kiwami (Windows),2916,1000,1916,55,60.0,1756.3333333333333
Yakuza 6: The Song of Life (Windows),1914,1000,914,59,40.0,1348.15
Yakuza 5 Remastered (Windows),2857,1000,1857,56,150.0,693.28
Yakuza 4 Remastered (Windows),2642,1000,1642,47,60.0,1286.2333333333333
Yakuza 3 Remastered (Windows),3203,1000,2203,50,60.0,1835.8333333333333
Yakuza 0 (Windows),4602,1000,3602,55,150.0,1320.7333333333333
YIIK: A Postmodern RPG (Windows),3030,1000,2030,26,30.0,1759.3333333333333
Xeno Crisis,3902,1000,2902,32,8.0,11608.0
XIII,2116,1000,1116,40,8.0,5580.0
XEL,3000,1000,2000,24,19.0,2526.315789473684
X-Morph: Defense,4011,1500,2511,40,36.0,2790.0
X-Force Genesis (Windows),1122,1000,122,10,1.0,1220.0
Wreckfest (Windows),3477,1000,2477,20,15.0,3302.6666666666665
Worms Rumble,10593,1000,9593,26,120.0,2078.483333333333
World War Z (Windows),4630,1000,3630,35,80.0,1588.125
World Soccer Pinball,1649,1000,649,15,1.0,9735.0
World Enduro Rally,2993,1270,1723,74,9.0,14166.888888888889
World Cruise Story,1510,1000,510,10,25.0,204.0
World At Arms (Windows),439,200,239,20,40.0,119.5
Wordament Snap Attack (Windows),442,200,242,19,80.0,57.475
Wordament (Windows),408,200,208,17,15.0,235.73333333333332
Wolfenstein: Youngblood (Windows),3632,1000,2632,60,50.0,3158.4
Wolfenstein: The Old Blood (Windows),2143,1000,1143,50,15.0,3810.0
Wolfenstein: The New Order (Windows),2192,1000,1192,50,12.0,4966.666666666667
Wolfenstein II: The New Colossus (Windows),4027,1000,3027,50,35.0,4324.285714285715
Wo Long: Fallen Dynasty,2655,1000,1655,51,40.0,2110.125
Wizards of Brandel,1428,1000,428,32,12.0,1141.3333333333333
Without a Voice (Windows),1009,1000,9,11,0.5,198.0
Witchcrafty (Windows),1260,1000,260,29,1.0,7540.0
Windjammers 2,5953,1000,4953,28,15.0,9245.6
Wind Peaks,1087,1000,87,14,1.0,1218.0
Wildfrost,3273,1000,2273,27,35.0,1753.4571428571428
WildTrax Racing,1040,1000,40,10,0.5,800.0
Who's Your Daddy?!,5032,1780,3252,33,1.0,107316.0
Who Pressed Mute on Uncle Marcus?,1288,1000,288,17,4.0,1224.0
While the Iron's Hot,3535,1000,2535,41,20.0,5196.75
When the Past Was Around,1201,1000,201,20,1.0,4020.0
Whacking Hell!,1440,1000,440,23,12.0,843.3333333333334
West of Dead (Windows),4237,1000,3237,22,20.0,3560.7
West Escape,1419,1000,419,33,32.0,432.09375
Werewolf Pinball,1771,1000,771,15,1.0,11565.0
Wer wei√ü denn sowas? - Das Spiel,1522,1000,522,37,10.0,1931.4
Wenjia,1760,1000,760,13,2.0,4940.0
Weird West: Definitive Edition,4240,1000,3240,53,25.0,6868.8
Weeping Willow (Windows),1000,1000,0,11,0.5,0.0
WeakWood Throne,1097,1000,97,21,2.0,1018.5
We Love Katamari REROLL+ Royal Reverie,2376,1000,1376,35,12.0,4013.3333333333335
We Happy Few,6054,1000,5054,40,40.0,5054.0
Wasteland Remastered,3579,1000,2579,35,25.0,3610.6
Wasteland 3 (Windows),4695,1000,3695,62,80.0,2863.625
Wasteland 2: Director's Cut,2852,1000,1852,46,80.0,1064.9
Wartales,5090,1000,4090,64,150.0,1745.0666666666666
Warp Bot (Windows),2070,2000,70,15,0.5,2100.0
Warm Snow,1840,1000,840,39,52.0,630.0
"Warhammer 40,000: Space Wolf (Windows)",2102,1000,1102,33,103.0,353.06796116504853
"Warhammer 40,000: Space Marine - Master Crafted Edition",8980,1000,7980,60,70.0,6840.0
"Warhammer 40,000: Rogue Trader",4236,1000,3236,64,205.0,1010.2634146341463
"Warhammer 40,000: Darktide",6307,1000,5307,36,120.0,1592.1
"Warhammer 40,000: Chaos Gate - Daemonhunters (Windows)",3203,1000,2203,48,457.0,231.38730853391684
"Warhammer 40,000: Boltgun",2579,1300,1279,15,8.5,2257.0588235294117
"Warhammer 40,000: Battlesector (Windows)",2604,1000,1604,30,15.0,3208.0
Wargroove 2,6186,1000,5186,23,25.0,4771.12
Wargroove,9737,1000,8737,23,60.0,3349.1833333333334
War Theatre,1698,1000,698,19,15.0,884.1333333333333
War Planet Online: Global Conquest (Windows),2308,1350,958,12,160.0,71.85
WORLDS Builder: Farm & Craft (Windows),2311,1048,1263,100,1000.0,126.3
Vzerthos: The Heir of Thunder (Windows),5843,5000,843,50,2.0,21075.0
Voodoo Vince: Remastered,1853,1000,853,41,12.0,2914.4166666666665
Voltron: Cubes of Olkarion (Windows),1416,1000,416,19,15.0,526.9333333333333
Visions of Mana,2077,1000,1077,45,40.0,1211.625
Visage,3746,1000,2746,27,10.0,7414.2
Virtual Families Cook Off: Chapter 1 Let's Go Flippin',1959,1000,959,20,94.0,204.04255319148936
Virtual Families 3: Our Country Home,2615,1000,1615,22,257.0,138.24902723735408
Venture Towns,1514,1000,514,10,10.0,514.0
Venba,1212,1000,212,15,1.0,3180.0
Varenje,1148,1000,148,26,3.0,1282.6666666666667
Vanity Fair: The Pursuit,1416,1000,416,32,7.0,1901.7142857142858
Vampyr (Windows),2645,1000,1645,28,20.0,2303.0
Vampire Survivors,2671,1450,1221,188,48.0,4782.25
Vampire Hunters,3708,1000,2708,48,85.0,1529.2235294117647
Vambrace: Cold Soul,3643,1000,2643,33,15.0,5814.6
VALA: Vicious Attack Llama Apocalypse,4528,1000,3528,20,20.0,3528.0
VA-11 Hall-A: Cyberpunk Bartender Action (Windows),1917,1000,917,33,3.0,10087.0
Unto The End,2146,1000,1146,11,3.0,4202.0
Unsouled,14618,1000,13618,52,35.0,20232.457142857143
Unruly Heroes (Windows),4447,1000,3447,26,23.0,3896.608695652174
Unpacking,1474,1000,474,25,1.0,11850.0
UnderMine,4536,1000,3536,96,80.0,4243.2
Undead Horde,1583,1000,583,24,10.0,1399.2
Umurangi Generation Special Edition,1620,1000,620,23,1.0,14260.0
Ultros,3682,1000,2682,31,36.0,2309.5
Ultimate Solitaire Collection,1676,1000,676,50,206.0,164.07766990291262
Ultimate Custom Night,6348,1000,5348,10,73.0,732.6027397260274
UNSIGHTED,6133,1000,5133,42,40.0,5389.65
UNO & Friends (Windows),416,200,216,20,100.0,43.2
Tyd wag vir Niemand,2148,1000,1148,14,6.0,2678.6666666666665
Ty the Tasmanian Tiger (Windows),544,200,344,20,20.0,344.0
Two Point Hospital (Windows),5092,1170,3922,26,68.0,1499.5882352941176
Two Point Campus,3134,1000,2134,35,40.0,1867.25
Twelve Minutes,1699,1000,699,12,2.0,4194.0
Turtle's Quest (Windows),1122,1000,122,11,1.0,1342.0
Turnip Boy Robs a Bank,1660,1000,660,23,5.0,3036.0
Turnip Boy Commits Tax Evasion,1391,1000,391,37,2.0,7233.5
Turn to Mine (Windows),1122,1000,122,13,0.5,3172.0
Turbo Golf Racing,4872,1000,3872,30,35.0,3318.8571428571427
Turbo Dash Kart 2024 Racing,1059,1000,59,10,4.0,147.5
Trucking 3D (Windows),662,300,362,20,5.0,1448.0
Tropico 6 (Windows),3363,1000,2363,40,40.0,2363.0
Tropical Resort Story,1779,1000,779,10,23.0,338.69565217391306
Trials of Mana,2440,1000,1440,44,40.0,1584.0
Tri6: Infinite,2379,1000,1379,24,8.0,4137.0
Trepang2,4334,1000,3334,49,43.0,3799.2093023255816
Trek to Yomi,5368,1000,4368,28,15.0,8153.6
Trash is Fun (Windows),5966,5000,966,30,0.5,57960.0
Transformers: Galactic Trials,2800,1000,1800,21,15.0,2520.0
Transformers: EarthSpark - Expedition,1525,1000,525,23,6.0,2012.5
Transformers: Battlegrounds,2221,1000,1221,20,15.0,1628.0
Tram Simulator Urban Transit,4281,1000,3281,23,161.0,468.7142857142857
Train Sim World: CSX Heavy Haul (Windows),2122,1000,1122,17,468.0,40.756410256410255
Train Sim World 5,3180,1000,2180,19,1.0,41420.0
Train Sim World 4,3910,1050,2860,31,13.0,6820.0
Train Sim World 3,3718,1040,2678,16,8.5,5040.941176470588
Train Sim World 2020 (Windows),3557,1000,2557,10,40.0,639.25
Train Sim World 2,8512,1085,7427,40,305.0,974.0327868852459
Trailmakers,4221,1200,3021,22,15.0,4430.8
Toy Soldiers Cold War: Touch Edition (Windows),385,200,185,20,12.0,308.3333333333333
Townscaper,1156,1000,156,10,0.5,3120.0
Touhou Luna Nights,3629,1000,2629,21,8.0,6901.125
Touchdown Pinball,2018,1000,1018,15,6.0,2545.0
Touchdown Hero: New Season (Windows),231,200,31,20,0.5,1240.0
Totally Reliable Delivery Service,4478,1015,3463,26,8.0,11254.75
Totally Accurate Battle Simulator,4148,1000,3148,64,8.0,25184.0
Total War: Warhammer III (Windows),7544,1060,6484,100,150.0,4322.666666666667
Total War: Warhammer II (Windows),1825,1000,825,106,150.0,583.0
Total War: Warhammer (Windows),2145,1105,1040,143,150.0,991.4666666666667
Total War: THREE KINGDOMS (Windows),8262,1073,7189,62,222.0,2007.7387387387387
Total Arcade Racing,1763,1000,763,10,6.0,1271.6666666666667
TorqueL -Physics Modified Edition-,1566,1000,566,13,17.0,432.8235294117647
Torii Guardian (Windows),1003,1000,3,10,0.5,60.0
Torchlight III,8948,1060,7888,59,325.0,1431.9753846153847
Toodee And Topdee,2964,1000,1964,20,20.0,1964.0
Tony Hawk's Pro Skater 1 + 2 (Windows),2358,1000,1358,36,74.0,660.6486486486486
Tomb Raider: Definitive Edition,2464,1000,1464,50,40.0,1830.0
Together We Live,1002,1000,2,10,0.5,40.0
Tofu Dream (Windows),2046,2000,46,15,0.5,1380.0
To The Sky,4303,1000,3303,10,19.0,1738.421052631579
Titans Pinball,1985,1000,985,15,2.0,7387.5
Tinytopia (Windows),1534,1000,534,66,21.0,1678.2857142857142
Tinykin,1541,1000,541,43,8.0,2907.875
Tiny Troopers 2: Special Ops (Windows),464,200,264,20,8.0,660.0
Tiny Troopers (Windows),523,200,323,20,6.0,1076.6666666666667
Tiny Little Farm (Windows),3161,3000,161,20,0.5,6440.0
Tin Hearts,6415,1000,5415,30,12.0,13537.5
Timespinner,1775,1000,775,37,12.0,2389.5833333333335
Time Trap: Hidden Objects Remastered,1528,1000,528,26,8.0,1716.0
Timberman VS,2528,1000,1528,25,12.0,3183.3333333333335
Tiles,2373,1000,1373,19,8.0,3260.875
Ticket to Ride: Classic Edition,3400,1000,2400,20,8.0,6000.0
Thymesia,2684,1000,1684,37,15.0,4153.866666666667
Thumper,4808,1000,3808,19,25.0,2894.08
Those Who Remain (Windows),1262,1000,262,14,6.0,611.3333333333334
This War of Mine: Final Cut,4172,1000,3172,23,20.0,3647.8
Thirsty Suitors,2252,1000,1252,26,10.0,3255.2
Thimbleweed Park,2180,1000,1180,33,8.0,4867.5
The Wolf Among Us (Windows),1080,1000,80,35,8.0,350.0
The Wild at Heart,2418,1000,1418,29,15.0,2741.4666666666667
The Wandering Village,14815,1490,13325,32,40.0,10660.0
The Walking Dead: The Final Season (Windows),1224,1000,224,48,8.0,1344.0
The Walking Dead: Season Two (Windows),1063,1000,63,40,8.0,315.0
The Walking Dead: Michonne (Windows),338,330,8,7,1.0,56.0
The Walking Dead: A New Frontier (Windows),211,200,11,6,1.0,66.0
The Walking Dead (Windows),1341,1000,341,48,10.0,1636.8
The VideoKid,1487,1000,487,10,2.0,2435.0
The Turing Test,1335,1000,335,15,6.0,837.5
The Touryst,1591,1000,591,10,6.0,985.0
The Thaumaturge,2617,1000,1617,56,55.0,1646.4
The Texas Chain Saw Massacre (Windows),3070,1000,2070,50,80.0,1293.75
The Talos Principle (Windows),2554,1000,1554,40,25.0,2486.4
The Sushi Spinnery,1343,1000,343,10,15.0,228.66666666666666
The Surge 2 (Windows),3099,1000,2099,47,20.0,4932.65
The Surge (Windows),3142,1000,2142,47,40.0,2516.85
The Super Penguboy (Windows 10),5223,5000,223,44,0.5,19624.0
The Strange Story Of Brian Fisher: Chapter 2,1430,1000,430,20,12.0,716.6666666666666
The Strange Story Of Brian Fisher: Chapter 1,1196,1000,196,10,2.0,980.0
The StoryTale (Windows),4515,4000,515,27,0.5,27810.0
The Smurfs 2: The Prisoner of the Green Stone,2516,1000,1516,36,37.0,1475.027027027027
The Smurfs - Dreams,1478,1000,478,21,11.0,912.5454545454545
The Smile Alchemist,1465,1000,465,31,20.0,720.75
The Sisters 2 - Road to Fame,1549,1000,549,43,11.0,2146.090909090909
The Shapeshifting Detective,1515,1000,515,21,5.0,2163.0
The Samurai Quest (Windows),1045,1000,45,10,0.5,900.0
The Riftbreaker (Windows),5185,1310,3875,47,28.0,6504.464285714285
The Rewinder,1725,1000,725,21,3.0,5075.0
The Ramen Sensei,2209,1000,1209,10,29.0,416.8965517241379
The Rabbit Crazy Adventure (Windows),4188,4000,188,43,0.5,16168.0
The Pyraplex,1399,1000,399,10,18.0,221.66666666666666
The Procession to Calvary,1279,1000,279,21,1.0,5859.0
The Penguin Factory (Windows),1763,1000,763,25,6.0,3179.1666666666665
The Pedestrian,1290,1000,290,10,0.5,5800.0
The Outer Worlds: Spacer's Choice Edition (Windows),1958,1000,958,68,40.0,1628.6
The Outer Worlds (Windows),3216,1000,2216,48,25.0,4254.72
The Oregon Trail,4168,1000,3168,74,276.0,849.3913043478261
The Mildew Children,1791,1000,791,32,9.0,2812.4444444444443
The Messenger (Windows),2216,1000,1216,40,12.0,4053.3333333333335
The Medium,1679,1000,679,39,8.0,3310.125
The Manga Works,1801,1000,801,10,27.0,296.6666666666667
The Lord of the Rings: Adventure Card Game - Definitive Edition,13721,1000,12721,50,432.0,1472.337962962963
The Long Dark,11035,1215,9820,56,162.0,3394.567901234568
The Legend of Tianding,3137,1000,2137,26,10.0,5556.2
The Legend of Cyber Cowboy,2890,2000,890,19,1.0,16910.0
The Last Shot (Windows),1267,1000,267,22,2.0,2937.0
The Last Kids on Earth and the Staff of Doom,2681,1000,1681,43,12.0,6023.583333333333
The Last Hero of Nostalgaia,4525,1000,3525,40,40.0,3525.0
The Last Door: Season 2 (Windows),1234,1000,234,16,6.0,624.0
The Last Case of Benedict Fox: Definitive Edition,2544,1000,1544,32,15.0,3293.866666666667
The Lamplighters League,3716,1000,2716,41,50.0,2227.12
The Knight Witch,1896,1000,896,27,12.0,2016.0
The King of Fighters XV (Windows),1525,1000,525,49,43.0,598.2558139534884
The Karate Kid: Street Rumble,3247,1000,2247,48,41.0,2630.6341463414633
The Jackbox Survey Scramble,1894,1000,894,10,1.0,8940.0
The Jackbox Party Starter,2374,1000,1374,20,10.0,2748.0
The Jackbox Party Pack 9,4045,1000,3045,20,10.0,6090.0
The Jackbox Party Pack 7,2538,1000,1538,20,3.0,10253.333333333334
The Jackbox Party Pack 10,2445,1000,1445,20,1.0,28900.0
The Jackbox Naughty Pack,2743,1000,1743,20,1.0,34860.0
The Isle Tide Hotel,1231,1000,231,26,6.0,1001.0
The Invincible,1865,1000,865,29,12.0,2090.4166666666665
The Inquisitor,2186,1000,1186,41,12.0,4052.1666666666665
The Innsmouth Case,1171,1000,171,23,1.0,3933.0
The House of Da Vinci 3,1760,1000,760,30,16.0,1425.0
The House of Da Vinci 2,1547,1000,547,24,11.0,1193.4545454545455
The House of Da Vinci,1279,1000,279,14,6.0,651.0
The Gunstringer: Dead Man Running (Windows),663,200,463,20,30.0,308.6666666666667
The Gunk,1634,1000,634,17,6.0,1796.3333333333333
The Grinch: Christmas Adventures,1243,1000,243,15,3.0,1215.0
The Great Wobo Escape (Windows),304,200,104,12,4.0,312.0
The Good Life,7175,1000,6175,42,60.0,4322.5
The Gardens Between,1122,1000,122,17,1.0,2074.0
The Forgotten City,1722,1000,722,40,8.0,3610.0
The Food Run (Windows),1040,1000,40,27,3.0,360.0
The Fast Journey (Windows),4134,4000,134,28,0.5,7504.0
The Falconeer,5489,1000,4489,29,15.0,8678.733333333334
The Explorer Of Night (Windows),4095,4000,95,25,0.5,4750.0
The Experiment: Escape Room,1240,1000,240,10,1.0,2400.0
The Excrawlers (Windows),2198,2000,198,15,0.5,5940.0
The Evil Within 2 (Windows),2262,1000,1262,51,20.0,3218.1
The Evil Within (Windows),4708,1735,2973,71,40.0,5277.075
The Escapists: The Walking Dead (Windows),1834,1000,834,19,12.0,1320.5
The Epyx Collection: Handheld,2739,1000,1739,20,5.0,6956.0
The Elder Scrolls V: Skyrim Special Edition (Windows),3418,1550,1868,75,8.0,17512.5
The Elder Scrolls IV: Oblivion Remastered,2633,1000,1633,60,40.0,2449.5
The Dungeon of Naheulbeuk: The Amulet of Chaos - Chicken Edition,6535,1000,5535,30,143.0,1161.188811188811
The Darkside Detective: A Fumble in the Dark,1512,1225,287,30,3.0,2870.0
The Darkside Detective,1382,1000,382,30,4.0,2865.0
The Dark Pictures Anthology: Man of Medan (Windows),3410,1000,2410,30,30.0,2410.0
The Complex,1238,1000,238,20,3.0,1586.6666666666667
The Coma 2: Vicious Sisters,2004,1000,1004,35,10.0,3514.0
The Catch: Carp & Coarse Fishing,16302,1000,15302,25,25.0,15302.0
The Casting of Frank Stone,2300,1000,1300,32,20.0,2080.0
The Case of the Golden Idol,1191,1000,191,12,0.5,4584.0
The Callisto Protocol,2605,1080,1525,30,32.0,1429.6875
The Bunker,1172,1000,172,28,2.0,2408.0
The Bookwalker: Thief of Tales,2304,1000,1304,37,10.0,4824.8
The Big Con,3105,1500,1605,52,6.0,13910.0
The Bard's Tale Trilogy,5819,1000,4819,47,40.0,5662.325
The Bard's Tale IV: Director's Cut,4513,1000,3513,59,50.0,4145.34
The Bard's Tale ARPG : Remastered and Resnarkled,1905,1000,905,51,2.0,23077.5
The Ascent,2755,1000,1755,46,20.0,4036.5
The Artful Escape,1227,1000,227,12,3.0,908.0
The Answer Is 42,1333,1000,333,15,0.5,9990.0
The Alters,7223,1000,6223,55,40.0,8556.625
The Adventures of Ally The Alligator (Windows),2097,2000,97,22,0.5,4268.0
That's My Family: Family Fun Night,2000,1000,1000,54,75.0,720.0
Tetris Effect: Connected,6715,1000,5715,42,80.0,3000.375
Tesla vs Lovecraft,1363,1000,363,20,12.0,605.0
Terror Mansion,1142,1000,142,10,0.5,2840.0
Terra Invicta (Windows),12656,1000,11656,90,160.0,6556.5
Terminal 81 (Windows),1345,1000,345,30,8.0,1293.75
Tents and Trees,2179,1000,1179,32,65.0,580.4307692307692
Tentacles: Enter the Mind (Windows),436,200,236,20,6.0,786.6666666666666
Tennis Manager 2021 (Windows),2725,1000,1725,76,1401.0,93.57601713062098
Tennis Club Story,1473,1000,473,10,32.0,147.8125
Tenderfoot Tactics,1621,1000,621,12,30.0,248.4
Ten Dates,1476,1000,476,19,6.0,1507.3333333333333
Tempopo,2861,1000,1861,25,5.0,9305.0
Telling Lies,1234,1000,234,15,1.0,3510.0
Tell Me Why,690,500,190,10,2.0,950.0
Teenage Mutant Ninja Turtles: Shredder's Revenge,2750,1000,1750,30,15.0,3500.0
Teenage Mutant Ninja Turtles: Mutants Unleashed,1847,1000,847,27,12.0,1905.75
Teenage Mutant Ninja Turtles Arcade: Wrath of the Mutants,1955,1000,955,20,6.0,3183.3333333333335
Tee Time Golf VR (Windows),2719,1400,1319,20,285.0,92.56140350877193
Team Crossword (Windows),359,200,159,20,15.0,212.0
Tchia,2098,1000,1098,21,20.0,1152.9
Tardy,1078,1000,78,11,1.0,858.0
Taptiles (Windows),481,200,281,20,80.0,70.25
Tapping Skill Test (Windows),2633,1000,1633,11,6.0,2993.8333333333335
Tamarin,3043,1000,2043,31,15.0,4222.2
Talisman: Digital Edition,3462,1000,2462,53,75.0,1739.8133333333333
Tales of Vesperia: Definitive Edition (Windows),3810,1000,2810,53,222.0,670.8558558558559
Tales of Arise (Windows),2602,1000,1602,47,40.0,1882.35
Tales from Toyotoki: Arrival of the Witch,1075,1000,75,23,0.5,3450.0
Tainted Grail: Conquest,3265,1000,2265,40,25.0,3624.0
Tails Noir,2394,1000,1394,26,6.0,6040.666666666667
Taiko no Tatsujin: The Drum Master!,5431,1000,4431,89,60.0,6572.65
Taiko no Tatsujin: Rhythm Festival,1815,1000,815,33,15.0,1793.0
TactiCats,2182,1000,1182,40,9.0,5253.333333333333
Tacoma,1128,1000,128,12,1.0,1536.0
TUNIC,2896,1000,1896,36,15.0,4550.4
TRANSIRUBY,2104,1000,1104,36,22.0,1806.5454545454545
TOEM,1442,1000,442,48,6.0,3536.0
TITAN SLAYER (Windows),2547,1000,1547,16,6.0,4125.333333333333
THE FINALS,5631,1000,4631,50,300.0,771.8333333333334
TEVI,4155,1000,3155,65,52.0,3943.75
TENSEI,1949,1000,949,33,11.0,2847.0
TENGAI,1979,1000,979,29,3.0,9463.666666666666
TAURONOS,2268,1000,1268,44,6.0,9298.666666666666
T-Kara Puzzles (Windows),2434,1000,1434,15,15.0,1434.0
Synchro Hedgehogs (Windows),3073,3000,73,20,0.5,2920.0
Symphonia ùÑû,6091,1000,5091,22,8.0,14000.25
Syberia - The World Before,1725,1000,725,31,12.0,1872.9166666666667
Swordbreaker: Origins (Windows),1028,1000,28,68,1.0,1904.0
Swordbreaker The Game,1005,1000,5,58,0.5,580.0
Sword of Elpisia,1507,1000,507,32,12.0,1352.0
Sword and Fairy: Together Forever,2148,1000,1148,37,20.0,2123.8
Sword & Fairy Inn 2,2708,1000,1708,24,36.0,1138.6666666666667
Swapshot (Windows),3117,3000,117,22,0.5,5148.0
Surviving Mars (Windows),1055,1000,55,50,0.5,5500.0
Survive on Raft,2064,1000,1064,36,12.0,3192.0
Surgeon Simulator 2 (Windows),5868,1000,4868,30,40.0,3651.0
Supraland: Six Inches Under,2837,1000,1837,53,15.0,6490.733333333334
Supraland (Windows),2171,1000,1171,60,15.0,4684.0
Supermarket Shriek,4296,1000,3296,42,8.0,17304.0
Superliminal,4457,1200,3257,23,9.0,8323.444444444445
Super Space Serpent SE,1441,1000,441,23,1.0,10143.0
Super Snake Block DX (Windows),2024,2000,24,15,0.5,720.0
Super Ninja Miner (Windows),5329,5000,329,38,0.5,25004.0
Super Lucky's Tale,3526,1280,2246,31,15.0,4641.733333333334
Super Jagger Bomb 2: Go East,2013,1000,1013,29,2.0,14688.5
Super Forklift 3000 (Windows),2040,2000,40,15,0.5,1200.0
Super Engine GT Turbo SPEC,1120,1000,120,16,1.0,1920.0
Super Dungeon Bros,7731,1000,6731,27,30.0,6057.9
Super Astro Cat (Windows),2087,2000,87,15,0.5,2610.0
Sunset Overdrive (Windows),6177,1745,4432,80,25.0,14182.4
Sunrise GP,1478,1000,478,20,4.0,2390.0
Sundered: Eldritch Edition,2425,1000,1425,20,15.0,1900.0
Sunbeam Feast (Windows),3122,3000,122,45,0.5,10980.0
Summer in Mara,1804,1000,804,42,25.0,1350.72
Suikoden I & II HD Remaster Gate Rune and Dunan Unification Wars,1902,1000,902,56,60.0,841.8666666666667
Suikaiju (Windows),2055,2000,55,15,0.5,1650.0
Suika And Dragons (Windows),1002,1000,2,10,0.5,40.0
Sugarbound (Windows),2141,2000,141,15,0.5,4230.0
Sudoku Classic X,1901,1000,901,14,12.0,1051.1666666666667
Subnautica: Below Zero,1840,1000,840,13,0.5,21840.0
Subnautica,1939,1000,939,17,1.0,15963.0
Submerged: Hidden Depths,1232,1000,232,14,6.0,541.3333333333334
SubaraCity,1477,1000,477,12,4.0,1431.0
SturmFront - The Mutant War: Ubel Edition,2215,1000,1215,17,5.0,4131.0
Stunt Paradise (Windows),4234,4000,234,40,0.5,18720.0
Stunt Kite Masters (Windows),1637,1000,637,10,3.0,2123.3333333333335
Strike Force Kitty,3971,1000,2971,31,27.0,3411.1481481481483
Streets of Rogue (Windows),2821,1000,1821,50,6.0,15175.0
Streets of Rage 4,4302,1000,3302,37,40.0,3054.35
Strayed Lights,2437,1000,1437,26,13.0,2874.0
Stray,2142,1000,1142,24,8.0,3426.0
Stranded Deep (Windows),5308,1000,4308,37,60.0,2656.6
Storyblocks: The King (Windows),4299,4000,299,31,0.5,18538.0
Story of Seasons: Friends of Mineral Town (Windows),2665,1000,1665,35,80.0,728.4375
Stones Keeper,1178,1000,178,12,1.0,2136.0
Still Wakes The Deep,2080,1000,1080,37,8.0,4995.0
Sticky Twig DASH! (Windows),2068,2000,68,15,0.5,2040.0
StickType,4246,1300,2946,24,6.0,11784.0
Steve Jackson's Sorcery!,2894,1000,1894,27,32.0,1598.0625
Stellaris (Windows),8690,2080,6610,64,300.0,1410.1333333333334
Stellar Interface,3279,1000,2279,100,79.0,2884.8101265822784
Stellar Docks: Deep Space (Windows),2018,2000,18,29,0.5,1044.0
Stellar Docks (Windows),2036,2000,36,29,0.5,2088.0
Steampunch (Windows),2028,2000,28,25,0.5,1400.0
SteamWorld Heist II,3196,1000,2196,34,81.0,921.7777777777778
SteamWorld Dig 2,3563,1000,2563,34,15.0,5809.466666666666
SteamWorld Build,2752,1000,1752,28,25.0,1962.24
Staying Fresh (Windows),1028,1000,28,10,0.5,560.0
Station Manager,1732,1000,732,10,64.0,114.375
State of Decay 2: Juggernaut Edition,10392,2400,7992,153,316.5,3863.4312796208533
Starlight Legacy,1627,1000,627,21,10.0,1316.7
Starfield,2416,1000,1416,50,80.0,885.0
Stardew Valley (Windows),3251,1000,2251,40,150.0,600.2666666666667
Starbound (Windows),1400,1000,400,51,12.0,1700.0
Star Trucker,9670,1000,8670,49,50.0,8496.6
Star Trek Prodigy: Supernova,1895,1000,895,41,12.0,3057.9166666666665
Star Renegades (Windows),6807,1180,5627,53,17.0,17543.0
Stampede: Racing Royale,2015,1000,1015,18,60.0,304.5
Spyro Reignited Trilogy,5945,3000,2945,105,25.0,12369.0
Spray Paint Simulator,2560,1000,1560,19,12.0,2470.0
SpotCat vs The Cheddar Mafia In The Americas,2053,2000,53,19,0.5,2014.0
Spot The Differences! Party,1278,1000,278,18,2.0,2502.0
Spot Challenge Vol. 4,2080,2000,80,19,0.5,3040.0
Spot Challenge Vol. 3,2106,2000,106,19,0.5,4028.0
Spot Challenge Vol. 2,2103,2000,103,19,0.5,3914.0
Spot Challenge Vol. 1,2148,2000,148,19,0.5,5624.0
SpongeBob SquarePants: The Patrick Star Game,2294,1000,1294,34,6.0,7332.666666666667
SpongeBob SquarePants: Battle for Bikini Bottom - Rehydrated (Windows),1800,1000,800,32,8.0,3200.0
Splitgate 2,14111,1000,13111,22,50.0,5768.84
Splash Blast Panic,5407,1000,4407,13,215.0,266.4697674418605
Spirittea,2480,1000,1480,15,60.0,370.0
Spiritfarer: Farewell Edition,2075,1000,1075,39,30.0,1397.5
Spirit of the North: Enhanced Edition,2233,1000,1233,24,6.0,4932.0
Spirit Valor,1592,1000,592,35,14.0,1480.0
Spirit Roots,1817,1000,817,25,8.0,2553.125
SpiderHeck,20102,1470,18632,39,95.0,7648.926315789474
Spider Solitaire F,1342,1000,342,10,15.0,228.0
Spheroids,1099,1000,99,16,3.0,528.0
Spelunky 2,9881,1000,8881,32,60.0,4736.533333333334
Speedway Racing,1200,1000,200,18,1.0,3600.0
Speed Truck Racing,1144,1000,144,16,1.0,2304.0
Spacelords,12000,1820,10180,32,260.0,1252.923076923077
Spacelines from the Far Out,3629,1000,2629,44,20.0,5783.8
Space Warlord Organ Trading Simulator,1464,1000,464,15,2.0,3480.0
Space Pirate Trainer (Windows),3056,1000,2056,10,3.0,6853.333333333333
Space Moves (Windows),3237,3000,237,20,0.5,9480.0
Space Hulk: Tactics (Windows),4887,1000,3887,25,42.0,2313.690476190476
Space Hulk: Deathwing - Enhanced Edition (Windows),2949,1000,1949,23,60.0,747.1166666666667
Space Filler (Windows),2496,2000,496,15,1.0,7440.0
Space Engineers,6837,1000,5837,29,150.0,1128.4866666666667
South of Midnight,2658,1000,1658,40,15.0,4421.333333333333
Soul Stalker,1945,1000,945,24,6.0,3780.0
Soul Hackers 2,4529,1000,3529,47,60.0,2764.383333333333
Songbringer,5745,1000,4745,32,42.0,3615.2380952380954
SongPop Party,2229,1055,1174,19,80.0,278.825
Somerville,1613,1000,613,11,4.0,1685.75
Solitaire TriPeaks Flowers,2256,1000,1256,24,25.0,1205.76
Solitaire 3D,2854,1000,1854,51,1005.0,94.08358208955224
Solir (Windows),2017,2000,17,55,0.5,1870.0
Solasta: Crown of the Magister,5026,1060,3966,82,120.0,2710.1
Solar Ash,3114,1000,2114,32,15.0,4509.866666666667
Sol Dorado Heist (Windows),1016,1000,16,19,0.5,608.0
Sokorobot (Windows),2077,2000,77,27,0.5,4158.0
Sokomonster (Windows),2071,2000,71,25,0.5,3550.0
Sokomage (Windows),3224,3000,224,26,0.5,11648.0
Sokolab (Windows),2054,2000,54,22,0.5,2376.0
Sokocrab (Windows),2010,2000,10,28,0.5,560.0
Sokobalien (Windows),4260,4000,260,37,0.5,19240.0
SokoNature,3378,3000,378,60,1.0,22680.0
Sokmeal Time (Windows),2025,2000,25,15,0.5,750.0
Soccer Story,2474,1000,1474,20,10.0,2948.0
Snufkin: Melody of Moominvalley,1441,1000,441,21,6.0,1543.5
SnowRunner (Windows),5952,1000,4952,37,120.0,1526.8666666666666
Snooker Blitz,3390,1000,2390,20,60.0,796.6666666666666
Sniper Elite: Resistance,3693,1000,2693,53,20.0,7136.45
Sniper Elite V2 Remastered,2324,1000,1324,47,15.0,4148.533333333334
Sniper Elite 5,2702,1000,1702,53,25.0,3608.24
Snake Pass,5073,1000,4073,33,15.0,8960.6
Smart Moves 2 (Windows),3050,3000,50,20,0.5,2000.0
Smart Moves (Windows),4275,4000,275,27,1.0,7425.0
Slime Ranger (Windows),3043,3000,43,45,0.5,3870.0
Slime Rancher,2455,1000,1455,57,25.0,3317.4
Slayers X: Terminal Aftermath: Vengance of the Slayer,1678,1000,678,19,0.5,25764.0
Skyworld (Windows),1731,1000,731,26,17.0,1118.0
Sky Survivors (Windows),3197,3000,197,20,0.5,7880.0
Sky Roll!,1257,1000,257,18,1.0,4626.0
Sky Rogue,4305,1000,3305,26,26.0,3305.0
Sky Revolver,1131,1000,131,18,0.5,4716.0
Skul: The Hero Slayer,6047,1000,5047,23,1.0,116081.0
Skelethrone: The Chronicles of Ericona,2921,1000,1921,43,93.0,888.2043010752689
SkateBIRD,8872,1320,7552,16,7.0,17261.714285714286
Sisters Royale: Five Sisters Under Fire,3896,1000,2896,44,29.0,4393.931034482759
Sins of a Solar Empire: Rebellion (Windows),2447,1000,1447,65,15.0,6270.333333333333
Silver Nornir,1284,1000,284,30,6.0,1420.0
Silence - The Whispered World 2,2394,1000,1394,46,15.0,4274.933333333333
Signs of the Sojourner,3092,1000,2092,14,15.0,1952.5333333333333
Sig.NULL (Windows),3098,3000,98,20,0.5,3920.0
Sifu,11280,1720,9560,61,28.0,20827.14285714286
Siegecraft Commander,1362,1000,362,12,3.0,1448.0
Sid Meier's Civilization VI,5379,1075,4304,44,42.0,4508.952380952381
SiNKR 2,1175,1000,175,20,1.0,3500.0
SiNKR,1107,1000,107,18,1.0,1926.0
Shy Dogs Hidden Orchestra,2169,2000,169,31,1.0,5239.0
Shy Cats Hidden Tracks - Vol. 2,2149,2000,149,23,0.5,6854.0
Shy Cats Hidden Tracks - Vol. 1,2276,2000,276,23,1.0,6348.0
Shy Cats Hidden Orchestra,2230,2000,230,31,1.0,7130.0
Shuffle Party (Windows),387,200,187,10,4.0,467.5
Shredders,3043,1000,2043,35,8.0,8938.125
Shovel Knight: Treasure Trove (Windows),4400,2000,2400,85,46.0,4434.782608695652
Shiro (Windows),3230,3000,230,20,1.0,4600.0
Shiny Ski Resort,1491,1000,491,10,16.0,306.875
Shin Megami Tensei V: Vengeance,3592,1000,2592,48,60.0,2073.6
Shield King (Windows),2199,2000,199,22,1.0,4378.0
Shenmue I & II (Windows),3809,2000,1809,55,40.0,2487.375
Sheltered (Windows),1926,1000,926,21,20.0,972.3
She Sees Red,1086,1000,86,14,1.0,1204.0
Shark Pinball,2177,1000,1177,15,12.0,1471.25
Shark Dash (Windows),225,200,25,20,1.0,500.0
ShapeNeon Chaos,3250,3000,250,30,0.5,15000.0
Shantae: Risky's Revenge - Director's Cut,2569,1000,1569,24,10.0,3765.6
Shalnor Legends 2: Trials of Thunder,1824,1000,824,25,22.0,936.3636363636364
Shakes on a Plane,2386,1000,1386,17,10.0,2356.2
Shady Part of Me,2138,1000,1138,16,6.0,3034.6666666666665
Shadowrun: Hong Kong - Extended Edition,3085,1000,2085,60,35.0,3574.285714285714
Shadowrun: Dragonfall - Director's Cut,3145,1000,2145,39,40.0,2091.375
Shadowrun Returns,2695,1000,1695,40,20.0,3390.0
Shadow of the Tomb Raider,1693,1000,693,63,40.0,1091.475
Shadow Warrior 3: Definitive Edition,1760,1000,760,38,6.0,4813.333333333333
Shadow Warrior 2 (Windows),3502,1000,2502,39,20.0,4878.9
Shadow Complex Remastered,4659,1000,3659,39,20.0,7135.05
Seven Doors,1117,1000,117,17,0.5,3978.0
Serious Sam: Siberian Mayhem (Windows),3321,1000,2321,49,20.0,5686.45
Serious Sam 4 (Windows),2099,1000,1099,54,6.0,9891.0
Sephirothic Stories,1425,1000,425,29,12.0,1027.0833333333333
Senua's Saga: Hellblade II,1553,1000,553,11,6.0,1013.8333333333334
Senshi Sokoban Quest (Windows),4319,4000,319,25,0.5,15950.0
Self-Delusion (Windows),1151,1000,151,20,3.0,1006.6666666666666
Seek Hearts,1383,1000,383,33,8.0,1579.875
Secrets and Treasure: The Lost Cities (Windows),214,120,94,9,8.0,105.75
Secret Neighbor,3012,1000,2012,10,6.0,3353.3333333333335
Second Extinction,4669,1000,3669,29,20.0,5320.05
Seasons of the Samurai,1085,1000,85,25,1.0,2125.0
Sea of Thieves,51784,5640,46144,286,2063.0,6397.083858458555
Sea of Stars,2785,1070,1715,48,40.0,2058.0
Sea Salt,4111,1000,3111,19,8.0,7388.625
Sea Horizon,1991,1000,991,20,42.0,471.9047619047619
Screw Master (Windows),1117,1000,117,70,2.0,4095.0
ScourgeBringer,4036,1000,3036,42,10.0,12751.2
Scorn,1414,1000,414,12,5.0,993.6
Scarlet Nexus,3093,1000,2093,53,60.0,1848.8166666666666
Say Cheese! (Windows),3131,3000,131,28,0.5,7336.0
Sausage Wars,1377,1000,377,25,2.0,4712.5
Sapu,2459,2000,459,50,1.5,15300.0
Sanguis Luna,1044,1000,44,10,0.5,880.0
Sand Legends,1020,1000,20,22,2.0,220.0
Samurai vs Zombies Defense (Windows),1247,200,1047,20,1000.0,20.94
Samurai Aces III: Sengoku Cannon,2514,1000,1514,26,12.0,3280.3333333333335
Samurai Aces,2148,1000,1148,29,3.0,11097.333333333334
Samsara,1101,1000,101,19,1.0,1919.0
Saints Row IV: Re-Elected (Windows),2038,1200,838,70,35.0,1676.0
Saint Kotar,1866,1135,731,45,6.0,5482.5
"Sagashi Mono wa, Natsu Desu Ka.",1018,1000,18,10,0.5,360.0
Saga of the Moon Priestess,2857,2000,857,26,3.5,6366.285714285715
Safari Pinball,2920,1000,1920,15,15.0,1920.0
Sable,2542,1110,1432,56,17.0,4717.176470588235
SUPERHOT: MIND CONTROL DELETE,2287,1000,1287,14,10.0,1801.8
SUPERHOT (Windows),5544,1000,4544,24,15.0,7270.4
STRIKERS 1945 III,4948,1000,3948,30,10.0,11844.0
STRIKERS 1945 II,10248,1000,9248,31,19.0,15088.842105263158
STRIKERS 1945,8153,1000,7153,32,17.0,13464.470588235294
SOMA,1355,1000,355,10,6.0,591.6666666666666
SOL DIVIDE -SWORD OF DARKNESS-,2103,1000,1103,30,2.0,16545.0
SMITE 2,2478,1000,1478,27,25.0,1596.24
SIGNALIS,2227,1000,1227,13,0.5,31902.0
SHMUP Mania (Windows),2084,2000,84,15,0.5,2520.0
SHINOBI NON GRATA,1873,1000,873,21,8.0,2291.625
SHENZHEN I/O (Windows),3106,1000,2106,10,15.0,1404.0
SHARK! SHARK!,1243,1000,243,10,3.0,810.0
SD Gundam Battle Alliance,2740,1000,1740,43,25.0,2992.8
SCHiM,3734,1000,2734,24,20.0,3280.8
SCARF,1823,1000,823,25,4.0,5143.75
S.T.A.L.K.E.R. 2: Heart of Chornobyl,5848,1000,4848,58,100.0,2811.84
Rush: A Disney Pixar Adventure,3401,1000,2401,50,15.0,8003.333333333333
Rush Rally Origins,2296,1000,1296,31,35.0,1147.8857142857144
Runestone Keeper,2873,1000,1873,20,68.0,550.8823529411765
Rune Factory 4 Special (Windows),4714,1000,3714,38,212.0,665.7169811320755
Ruku's Heart Balloon,2516,1000,1516,22,19.0,1755.3684210526317
Ruinverse,1488,1000,488,34,20.0,829.6
Ruiner,8974,1500,7474,33,25.0,9865.68
Ruff Ghanor,7579,1000,6579,20,16.0,8223.75
Rubber Bandits,1968,1000,968,19,1.0,18392.0
Royal Envoy 2 Special Edition (Windows),294,200,94,20,8.0,235.0
Roofcats Band - Suika Style,2680,2000,680,20,15.5,877.4193548387096
Romancing SaGa 3,2251,1000,1251,41,200.0,256.455
Romancing SaGa 2,3043,1000,2043,42,80.0,1072.575
"Rolling Hills: Make Sushi, Make Friends",1765,1000,765,12,12.0,765.0
Rollerdrome (2022),4096,1000,3096,21,8.0,8127.0
Rollerdrome,2261,1000,1261,21,5.0,5296.2
Rogue Wizards,3128,1000,2128,18,44.0,870.5454545454545
Rogue Waters,4097,1000,3097,18,71.0,785.1549295774648
Rocket Riot 3D (Windows),286,200,86,12,4.0,258.0
Rocket Riot (Windows),1134,1000,134,12,4.0,402.0
Rocket Rats (Windows),2038,2000,38,16,0.5,1216.0
Rock 'N Racing Off Road DX,1200,1000,200,14,1.0,2800.0
Rock 'N Racing Grand Prix,1286,1000,286,22,3.0,2097.3333333333335
Roboquest,3240,1170,2070,86,42.0,4238.571428571428
Robolifter (Windows),3138,3000,138,20,0.5,5520.0
Robin Hood - Sherwood Builders,5593,1000,4593,100,66.0,6959.090909090909
Road 96: Mile 0,1707,1000,707,15,8.0,1325.625
Road 96,1505,1000,505,12,6.0,1010.0
Riverbond,1735,1100,635,57,4.5,8043.333333333333
River City Girls (Windows),2507,1000,1507,29,8.0,5462.875
Rise of the Tomb Raider (Windows),2832,1000,1832,66,40.0,3022.8
Rise of Nations: Extended Edition (Windows),5177,1000,4177,38,60.0,2645.4333333333334
Riptide GP: Renegade,2425,1000,1425,24,10.0,3420.0
Ring of Pain,10405,1555,8850,138,84.0,14539.285714285714
Ridiculous Marathon (Windows),365,200,165,20,20.0,165.0
Richman 11,4502,3000,1502,22,6.0,5507.333333333333
Richman 10,2661,1000,1661,28,68.0,683.9411764705883
Rex Rocket,2519,1000,1519,38,27.0,2137.8518518518517
Reverie: Sweet As Edition (Windows),1330,1000,330,35,5.0,2310.0
Revenge of the Savage Planet (Windows),2248,1000,1248,42,15.0,3494.4
Revenant Saga,2002,1000,1002,48,15.0,3206.4
Revenant Dogma,2513,1000,1513,30,15.0,3026.0
Return to Monkey Island,2881,1000,1881,39,15.0,4890.6
Return to Grace,1431,1000,431,35,4.0,3771.25
Retro Classics,13174,1000,12174,13,44.0,3596.8636363636365
Restless Hero,1201,1000,201,15,5.0,603.0
Resident Evil 7: Biohazard Grotesque Ver.,1516,1000,516,37,15.0,1272.8
Resident Evil 7: Biohazard,2551,1000,1551,37,20.0,2869.35
Resident Evil 3: Z Version,1146,1000,146,32,8.0,584.0
Resident Evil 3,1862,1000,862,32,20.0,1379.2
Resident Evil 2: Z Version,1356,1070,286,44,16.0,786.5
Resident Evil 2,2373,1070,1303,44,27.0,2123.4074074074074
Repentant,1016,1000,16,10,0.5,320.0
Remnant: From the Ashes,2154,1000,1154,40,40.0,1154.0
Remnant II,2123,1000,1123,50,60.0,935.8333333333334
Redfall,3572,1000,2572,66,40.0,4243.8
RedRaptor,2151,2000,151,16,1.0,2416.0
Red Panda is Hungry (Windows),2115,2000,115,15,0.5,3450.0
Record of Lodoss War -Deedlit in Wonder Labyrinth-,3115,1000,2115,25,8.0,6609.375
Recompile,2951,1000,1951,25,6.0,8129.166666666667
Reckless Racing Ultimate (Windows),742,200,542,20,20.0,542.0
Realpolitiks New Power,4603,1000,3603,47,101.0,1676.6435643564357
ReactorX 3 (Windows),2132,2000,132,15,0.5,3960.0
ReactorX 2 (Windows),5458,5000,458,30,0.5,27480.0
ReactorX (Windows),5146,5000,146,30,0.5,8760.0
ReCore,5415,1500,3915,73,48.0,5954.0625
Re:Touring (Windows),1018,1000,18,13,0.5,468.0
Rayman Jungle Run (Windows),552,200,352,18,5.0,1267.2
Rayman Fiesta Run (Windows),318,200,118,25,7.0,421.42857142857144
Rayland 2 (Windows),3119,3000,119,22,0.5,5236.0
Ravenlok,1550,1000,550,50,4.0,6875.0
Rally Rock 'N Racing,1210,1000,210,16,1.0,3360.0
Rally Racers,1108,1000,108,50,4.0,1350.0
Raji: An Ancient Epic Enhanced Edition,2159,1000,1159,21,5.0,4867.8
Rainbow Billy: The Curse of the Leviathan,1891,1000,891,39,15.0,2316.6
Rain on Your Parade,2400,1000,1400,22,6.0,5133.333333333333
Railway Islands 2,1302,1000,302,15,2.0,2265.0
Railway Empire 2,5086,1030,4056,56,60.5,3754.314049586777
Railroads Online,3263,1000,2263,32,105.0,689.6761904761905
Raging Loop,1087,1000,87,30,0.5,5220.0
Raging Bytes,2004,1000,1004,36,15.0,2409.6
Race with Ryan,1658,1000,658,23,3.0,5044.666666666667
Raccoon is Hungry (Windows),1017,1000,17,10,0.5,340.0
Rabio (Windows),5455,5000,455,30,0.5,27300.0
Rabbids Big Bang (Windows),422,200,222,20,8.0,555.0
RPGolf Legends,2629,1000,1629,40,15.0,4344.0
RPG Time: The Legend of Wright,2068,1000,1068,15,6.0,2670.0
RESEARCH and DESTROY,6227,1000,5227,45,20.0,11760.75
REPLICA,1062,1000,62,10,0.5,1240.0
REPLAY BOYS,1041,1000,41,14,0.5,1148.0
REMATCH,2717,1000,1717,37,31.0,2049.3225806451615
REKT! High Octane Stunts,1942,1000,942,17,6.0,2669.0
RAINBOW HIGH: RUNWAY RUSH,1225,1000,225,29,3.0,2175.0
RAGE 2 (Windows),4136,1045,3091,47,30.0,4842.566666666667
R.B.I. Baseball 20 (Windows),1793,1000,793,20,32.0,495.625
Quest Hunter,1715,1000,715,70,25.0,2002.0
Quartz Caverns (Windows),2079,2000,79,23,0.5,3634.0
Quantum Break,1613,1000,613,42,15.0,1716.4
Quake II,1765,1000,765,13,1.0,9945.0
Quake Champions (Windows),6159,1000,5159,52,328.0,817.890243902439
Quake,4332,1000,3332,35,1.0,116620.0
Q.U.B.E. 10th Anniversary,1945,1000,945,24,6.0,3780.0
Pyramid Platformer - The Gem Heist (Windows),3151,3000,151,20,0.5,6040.0
PuzzlePet - Feed Your Cat,3536,3000,536,30,0.5,32160.0
Puzzle by Nikoli X Sudoku (Windows),209,200,9,5,1.0,45.0
Puzzle by Nikoli W Yajilin (Windows),1126,1000,126,10,2.0,630.0
Puzzle by Nikoli W Sudoku (Windows),1072,1000,72,10,1.0,720.0
Puzzle by Nikoli W Slitherlink (Windows),1103,1000,103,10,1.0,1030.0
Puzzle by Nikoli W Shikaku (Windows),1094,1000,94,10,1.0,940.0
Puzzle by Nikoli W Nurikabe (Windows),1083,1000,83,10,2.0,415.0
Puzzle by Nikoli W Numberlink (Windows),1090,1000,90,10,1.0,900.0
Puzzle by Nikoli W Masyu (Windows),1090,1000,90,10,1.0,900.0
Puzzle by Nikoli W Kakuro (Windows),1162,1000,162,10,2.0,810.0
Puzzle by Nikoli W Hitori (Windows),1090,1000,90,10,1.0,900.0
Puzzle by Nikoli W Heyawake (Windows),1070,1000,70,10,1.0,700.0
Puzzle by Nikoli W Hashiwokakero (Windows),1101,1000,101,10,2.0,505.0
Puzzle by Nikoli W Akari (Windows),1048,1000,48,10,1.0,480.0
Pupperazzi,1728,1000,728,23,3.0,5581.333333333333
Punch Monk (Windows),2074,2000,74,55,0.5,8140.0
Psychonauts 2,1965,1000,965,57,25.0,2200.2
Project Winter,4000,1000,3000,38,20.0,5700.0
Project Wingman,3523,1000,2523,40,40.0,2523.0
Project Spark (Windows),3037,1000,2037,91,80.0,2317.0875
Prodeus,3324,1000,2324,30,15.0,4648.0
Prizma Puzzle Prime (Windows),5428,5000,428,32,0.5,27392.0
Prison of Illusion (Windows),2011,2000,11,16,0.5,352.0
Prison Architect (Windows),2495,1000,1495,16,20.0,1196.0
Primal Survivors (Windows),4511,4000,511,38,1.0,19418.0
Primal Light,3031,1000,2031,17,19.0,1817.2105263157894
Prey (Windows),3710,1000,2710,48,35.0,3716.5714285714284
Preserve,5386,1000,4386,36,57.0,2770.1052631578946
PowerWash Simulator,2767,1000,1767,40,40.0,1767.0
Power Rangers: Battle for the Grid,8268,1000,7268,34,40.0,6177.8
Potion Craft: Alchemist Simulator,5012,1000,4012,29,40.0,2908.7
Potata: fairy flower (Windows),1307,1000,307,21,5.0,1289.4
Post Trauma,1675,1000,675,15,5.0,2025.0
Possum is Hungry (Windows),1008,1000,8,10,0.5,160.0
Porkshire Hero (Windows),2041,2000,41,55,0.5,4510.0
Pool Slide Story,1558,1000,558,10,16.0,348.75
Pool Blitz,3364,1000,2364,20,40.0,1182.0
Police Simulator: Patrol Officers,2816,1000,1816,25,12.0,3783.3333333333335
Pocket Stables,1797,1000,797,10,28.0,284.64285714285717
Pocket League Story,1201,1000,201,10,12.0,167.5
Pocket Harvest,1564,1000,564,10,10.0,564.0
Pocket Clothier,1338,1000,338,10,12.0,281.6666666666667
Pocket Arcade Story,1852,1000,852,10,15.0,568.0
Pocket Academy,1462,1000,462,10,24.0,192.5
Please Be Happy (Windows),1006,1000,6,14,0.5,168.0
PlateUp!,3222,1000,2222,26,0.5,115544.0
Planet of Lana,2670,1000,1670,25,6.0,6958.333333333333
Plague Road,1683,1000,683,10,10.0,683.0
Pirates Pinball,1754,1000,754,15,2.0,5655.0
Pirate Trails (Windows),2031,2000,31,26,0.5,1612.0
Pirate Bloopers (Windows),3287,3000,287,20,0.5,11480.0
Pinball FX3,3018,1005,2013,12,9.0,2684.0
Pinball FX2,15912,1070,14842,17,112.0,2252.8035714285716
Pilot Sports,2981,1000,1981,14,17.0,1631.4117647058824
Pillars of Eternity 2: Deadfire - Ultimate Edition (Windows),1077,1000,77,54,60.0,69.3
Pillars of Eternity (Windows),2561,1000,1561,20,60.0,520.3333333333334
PictoQuest,1211,1000,211,26,8.0,685.75
Phoenotopia: Awakening,2643,1000,1643,33,81.0,669.3703703703703
Phoenix Wright: Ace Attorney Trilogy,3068,1000,2068,30,40.0,1551.0
Phoenix Point,7281,1000,6281,47,200.0,1476.035
Phantom Dust,4767,1000,3767,45,20.0,8475.75
Phantom Abyss,6323,1000,5323,18,25.0,3832.56
Phantasy Star Online 2 New Genesis,4663,1600,3063,45,69.0,1997.608695652174
Persona 5 Tactica,2055,1000,1055,39,40.0,1028.625
Persona 5 Royal,1595,1000,595,52,100.0,309.4
Persona 4 Golden,2199,1000,1199,49,80.0,734.3875
Persona 3 Reload,1705,1000,705,48,80.0,423.0
Persona 3 Portable,2898,1000,1898,35,80.0,830.375
Perfect Ninja Painter 3 (Windows),2048,2000,48,15,0.5,1440.0
Perfect Ninja Painter 2 (Windows),4221,4000,221,26,0.5,11492.0
Perfect Ninja Painter (Windows),4135,4000,135,25,0.5,6750.0
Peppa Pig: World Adventures,1088,1000,88,12,0.5,2112.0
Pentiment,1889,1000,889,41,20.0,1822.45
Penguin Flight: Beyond The Clouds (Windows),2017,2000,17,29,0.5,986.0
Penguin Flight (Windows),2010,2000,10,29,0.5,580.0
Peepaw's Farm,1012,1000,12,10,0.5,240.0
Pato Box,4836,1000,3836,51,26.0,7524.461538461538
Pathway (Windows),3833,1000,2833,75,40.0,5311.875
Pathologic 2,1532,1000,532,49,0.5,52136.0
Pathfinders: Memories,1202,1000,202,67,2.0,6767.0
Path of Giants,1416,1000,416,17,2.0,3536.0
Paradise Killer,1428,1000,428,39,12.0,1391.0
Paper io 2,1449,1000,449,24,8.0,1347.0
Paper Bad,1017,1000,17,22,0.5,748.0
Panzer Corps 2 (Windows),6843,880,5963,30,193.0,926.8911917098445
Pandemic: The Board Game,5475,1200,4275,24,17.0,6035.294117647059
Panda's Village (Windows),2055,2000,55,15,0.5,1650.0
Palworld,13320,2355,10965,56,56.5,10867.964601769912
Paladin's Passage,2815,1000,1815,14,14.0,1815.0
Paintball 3 - Candy Match Factory,2851,1000,1851,29,17.0,3157.5882352941176
Pac-Man Museum+,10880,1000,9880,41,60.0,6751.333333333333
Pac-Man Championship Edition DX+ (Windows),225,200,25,12,1.0,300.0
Pac-Man Championship Edition DX+ (VAIO) (Windows),200,200,0,12,0.5,0.0
Pac-Man Championship Edition DX+ (Toshiba) (Windows),200,200,0,12,1.0,0.0
PJ Masks Power Heroes: Mighty Alliance,1143,1000,143,19,6.0,452.8333333333333
PICO PARK 2,5391,1000,4391,30,24.0,5488.75
PHOGS!,2647,1000,1647,30,12.0,4117.5
PC Building Simulator,5067,1000,4067,51,150.0,1382.78
PAYDAY 3,5611,1000,4611,22,30.0,3381.4
PAW Patrol: Mighty Pups Save Adventure Bay,1521,1000,521,30,3.0,5210.0
PAW Patrol: Grand Prix,2508,1000,1508,15,12.0,1885.0
PAW Patrol World,1805,1000,805,21,6.0,2817.5
PAW Patrol The Movie: Adventure City Calls,2077,1000,1077,30,6.0,5385.0
Overrogue,1877,1000,877,26,20.0,1140.1
Overdriven Reloaded: Special Edition,2893,1000,1893,70,12.0,11042.5
Overdriven Evolution,4670,1000,3670,75,10.0,27525.0
Overdrive Blaster (Windows),3293,3000,293,22,0.5,12892.0
Overcooked! 2 (Windows),3607,1000,2607,26,8.0,8472.75
Outriders,2246,1045,1201,46,41.0,1347.4634146341464
Outer Wilds,2467,1035,1432,18,20.0,1288.8
Out of Moves (Windows),2026,2000,26,23,0.5,1196.0
Out of Line,1300,1000,300,16,2.0,2400.0
Orten Was The Case,1932,1000,932,17,13.0,1218.7692307692307
Ori and the Will of the Wisps,3378,1000,2378,37,20.0,4399.3
Ori and the Blind Forest: Definitive Edition,4123,1250,2873,57,20.0,8188.05
Order & Chaos Online (Windows),597,200,397,20,60.0,132.33333333333334
Orcs Must Die! Deathtrap,3265,1000,2265,30,80.0,849.375
Orcs Must Die! 3,3856,1000,2856,26,35.0,2121.6
Orange Season,2907,1000,1907,32,60.0,1017.0666666666667
Opus: Echo of Starsong ‚Äì Full Bloom Edition,5012,1000,4012,40,20.0,8024.0
Opus Magnum (Windows),1762,1000,762,10,20.0,381.0
Operencia: The Stolen Sun,3695,1000,2695,47,20.0,6333.25
Open Roads,1137,1000,137,16,0.5,4384.0
Opaloid Kingdom (Windows),2068,2000,68,15,0.5,2040.0
Onigo Hunter,1748,1000,748,29,15.0,1446.1333333333334
One True Hero,5528,1000,4528,30,31.0,4381.935483870968
One Step From Eden,3827,1000,2827,35,40.0,2473.625
One Step After Fall (Windows),2057,2000,57,15,0.5,1710.0
One Lonely Outpost,1793,1000,793,31,0.5,49166.0
One Leaves,1513,1000,513,14,2.0,3591.0
One Button Games 5-in-1 vol. 2 (Windows),1078,1000,78,55,0.5,8580.0
One Button Games 5-in-1 (Windows),1021,1000,21,55,0.5,2310.0
On A Roll 3D,1908,1000,908,30,5.0,5448.0
Omno,1586,1000,586,21,3.0,4102.0
Olija,1594,1000,594,10,4.0,1485.0
Old Man's Journey,1168,1000,168,12,1.0,2016.0
Oh! Edo Towns,1379,1000,379,10,12.0,315.8333333333333
Offworld Trading Company (Windows),4393,1000,3393,45,38.0,4018.0263157894738
Octopath Traveler II,3367,1000,2367,33,80.0,976.3875
Octopath Traveler,6135,1000,5135,88,100.0,4518.8
Oceanhorn 2: Knights of the Lost Realm,2250,1000,1250,34,20.0,2125.0
Ocean Keeper,1186,1000,186,16,6.0,496.0
Obsurity (Windows),3341,3000,341,20,1.0,6820.0
Observer: System Redux,2213,1000,1213,23,12.0,2324.9166666666665
Observation,1808,1000,808,11,6.0,1481.3333333333333
OXENFREE,1802,1000,802,13,10.0,1042.6
OVERWHELM (Windows),1262,1000,262,10,1.0,2620.0
ONE PIECE: PIRATE WARRIORS 4 (Windows),2613,1000,1613,40,25.0,2580.8
OMORI,2860,1000,1860,41,60.0,1271.0
Nox Dash (Windows),2084,2000,84,40,0.5,6720.0
Nowhere Prophet,3880,1000,2880,27,40.0,1944.0
Not Not - A Brain Buster,2152,1000,1152,20,2.0,11520.0
Noob - The Factionless,3801,1000,2801,73,158.0,1294.132911392405
Nongunz: Doppelganger Edition,8268,1000,7268,26,25.0,7558.72
Noel The Mortal Fate,1639,1000,639,38,15.0,1618.8
Nobody Saves the World,2420,1000,1420,33,25.0,1874.4
No More Heroes 3 (Windows),6229,1000,5229,51,60.0,4444.65
No Man's Sky,2966,1000,1966,27,50.0,1061.64
Ninja Village,1320,1000,320,10,15.0,213.33333333333334
Ninja Master Toru (Windows),2067,2000,67,15,0.5,2010.0
Ninja Gaiden Œ£2,5516,1000,4516,41,100.0,1851.56
Ninja Gaiden Œ£,7984,1000,6984,51,120.0,2968.2
Ninja Gaiden 3: Razor's Edge,8399,1000,7399,48,60.0,5919.2
Ninja Escape Danger (Windows),2045,2000,45,25,0.5,2250.0
Nine Sols,2456,1000,1456,35,30.0,1698.6666666666667
Nikoderiko: The Magical World,5640,1175,4465,36,64.0,2511.5625
Night Reverie,1154,1000,154,16,2.0,1232.0
Night Call (Windows),4127,1000,3127,46,100.0,1438.42
Night Book,1228,1000,228,17,3.0,1292.0
NieR: Automata BECOME AS GODS Edition (Windows),2006,1000,1006,48,4.0,12072.0
Nickelodeon All-Star Brawl 2,5316,1000,4316,28,12.0,10070.666666666666
Nick Jr. Party Adventure,1245,1000,245,19,2.0,2327.5
Ni no Kuni: Wrath of the White Witch Remastered,4234,1000,3234,33,80.0,1334.025
Ni no Kuni II: Revenant Kingdom - The Prince's Edition,3261,1000,2261,62,80.0,1752.275
Next Space Rebels,6289,1000,5289,25,40.0,3305.625
Nexoria: Dungeon Rogue Heroes,4581,4000,581,30,3.0,5810.0
New Super Lucky's Tale,2170,1000,1170,54,10.0,6318.0
Neverout,1176,1000,176,14,1.0,2464.0
NeverAwake,2244,1000,1244,29,12.0,3006.3333333333335
Neptunia: Sisters VS Sisters,2779,1000,1779,52,50.0,1850.16
Neptunia Game Maker R:Evolution,2946,1000,1946,50,62.0,1569.3548387096773
Neoverse,3927,1000,2927,37,60.0,1804.9833333333333
Neon White,3856,1000,2856,44,20.0,6283.2
Neon Chrome,2458,1000,1458,14,15.0,1360.8
Neon Abyss (Windows),4949,1000,3949,36,40.0,3554.1
Nefiriya and the Sands of Eternity (Windows),2103,2000,103,15,0.5,3090.0
Necromunda: Hired Gun,2958,1000,1958,48,15.0,6265.6
Narita Boy (Windows),2216,1000,1216,34,6.0,6890.666666666667
Narcissus,2794,1000,1794,21,1.0,37674.0
NORCO,1890,1000,890,35,6.0,5191.666666666667
NO THING,1009,1000,9,12,0.5,216.0
NINJA GAIDEN 2 Black,7470,1000,6470,38,60.0,4097.666666666667
NARAKA: BLADEPOINT,4401,1000,3401,40,150.0,906.9333333333333
Mythwrecked: Ambrosia Island,1434,1000,434,32,8.0,1736.0
Mystic Pathways: Crystal Quest (Windows),1025,1000,25,23,0.5,1150.0
Mystic Pathways (Windows),2029,2000,29,28,0.5,1624.0
Mystic Gate,2959,2000,959,30,4.0,7192.5
Myst,1742,1000,742,26,6.0,3215.3333333333335
MyMait√™ (Windows),4201,4000,201,25,0.5,10050.0
My Time at Sandrock Online,3180,1000,2180,30,60.0,1090.0
My Time at Sandrock,2134,1000,1134,30,80.0,425.25
My Little Universe,1867,1000,867,76,35.0,1882.6285714285714
My Little Pony: A Zephyr Heights Mystery,1405,1000,405,15,10.0,607.5
My Life: Pet Vet,1430,1000,430,40,11.0,1563.6363636363637
My Friend Peppa Pig,1262,1000,262,11,0.5,5764.0
My Friend Pedro (Windows),3724,1000,2724,30,15.0,5448.0
My Brother Rabbit,1046,1000,46,30,2.0,690.0
My Bakery Empire,1683,1000,683,20,24.0,569.1666666666666
Mute Crimson DX,2044,1000,1044,28,3.0,9744.0
Mutant Year Zero: Road to Eden,3711,1010,2701,37,20.5,4874.975609756098
Musical Vibes RX,1752,1000,752,16,2.0,6016.0
Mushroom Savior (Windows),3348,3000,348,20,1.0,6960.0
Mummy Pinball,1927,1000,927,15,1.0,13905.0
Mudness Offroad - 4x4 Truck Car Simulator,1898,1000,898,10,4.0,2245.0
Mr.Slime in Dungeon (Windows),3036,3000,36,20,0.5,1440.0
Mr. T-Shirt (Windows),3131,3000,131,45,0.5,11790.0
Mr Trials,1722,1000,722,11,2.0,3971.0
Moving Out 2,3666,1000,2666,28,15.0,4976.533333333334
Moving Out (Windows),2811,1000,1811,26,8.0,5885.75
Moving Houses,1265,1000,265,12,3.0,1060.0
Moves (Windows),2048,2000,48,15,0.5,1440.0
Mount & Blade: Warband (Windows),1067,1000,67,56,10.0,375.2
MotoGP 24,2071,1000,1071,50,25.0,2142.0
MotoGP 22,2701,1000,1701,50,25.0,3402.0
Mortisomem (Windows),1088,1000,88,14,2.0,616.0
Mortal Shell: Enhanced Edition,5385,1000,4385,25,20.0,5481.25
Mortal Kombat 11,2301,1000,1301,58,40.0,1886.45
Morkredd,4592,1000,3592,22,6.0,13170.666666666666
Moonscars,3549,1000,2549,33,15.0,5607.8
Moonlighter,4284,1000,3284,57,25.0,7487.52
Moonglow Bay,2941,1000,1941,37,25.0,2872.68
Monsters Love Candy (Windows),786,200,586,20,40.0,293.0
Monster Viator,1396,1000,396,26,25.0,411.84
Monster Train 2,4108,1000,3108,50,100.0,1554.0
Monster Train,3365,1000,2365,53,20.0,6267.25
Monster Sanctuary (Windows),4429,1200,3229,41,29.0,4565.137931034483
Monster Island (Windows),322,200,122,18,8.0,274.5
Monster Hunter Rise,6088,1000,5088,50,300.0,848.0
Monster High: Skulltimate Secrets,1198,1000,198,20,2.0,1980.0
Monster Go! (Windows),1042,300,742,30,80.0,278.25
Monster Boy and the Cursed Kingdom,1773,1000,773,32,20.0,1236.8
Monochrome Order,1635,1000,635,35,20.0,1111.25
Mondealy,2045,1000,1045,25,16.0,1632.8125
Mokoko X,1538,1000,538,70,4.0,9415.0
Mob Control,1251,1000,251,12,4.0,753.0
Mitsurugi Kamui Hikae (Windows),1584,1000,584,33,9.0,2141.3333333333335
Miraculous - Paris Under Siege,1494,1000,494,16,7.0,1129.142857142857
Miracle Snack Shop,1828,1000,828,34,8.0,3519.0
Minos Dungeon (Windows),2024,2000,24,30,0.5,1440.0
Mineral,2834,1000,1834,35,16.0,4011.875
Mineko's Night Market,2371,1000,1371,24,30.0,1096.8
Minecraft: Story Mode - Season Two (Windows),213,200,13,6,1.0,78.0
Minecraft: Story Mode - A Telltale Games Series (Windows),238,200,38,7,1.0,266.0
Minecraft Legends,15088,2000,13088,40,22.0,23796.363636363636
Minecraft Dungeons,11433,2220,9213,73,52.5,12810.457142857143
Minecraft (Windows),8129,2950,5179,130,30.0,22442.333333333332
MindSeize (Windows),2068,1000,1068,17,14.0,1296.857142857143
Mind Scanners,2958,1000,1958,14,15.0,1827.4666666666667
Mimi the Cat: New Friends (Windows),2010,2000,10,23,0.5,460.0
Mimi the Cat: Mimi's Scratcher (Windows),4539,4000,539,32,0.5,34496.0
Mimi the Cat: Meow Together (Windows),2113,2000,113,24,1.0,2712.0
Miles & Kilo,1844,1000,844,20,4.0,4220.0
Mighty Mage (Windows),2029,2000,29,15,0.5,870.0
Mighty Goose,2045,1000,1045,18,6.0,3135.0
Midnight Fight Express,5084,1000,4084,40,40.0,4084.0
Miden Tower,1428,1000,428,33,15.0,941.6
Middle-earth: Shadow of War,1799,1010,789,53,60.0,696.95
Microsoft Ultimate Word Games (Windows),2915,1000,1915,38,150.0,485.1333333333333
Microsoft Treasure Hunt (Windows),3260,1000,2260,20,30.0,1506.6666666666667
Microsoft Treasure Hunt (Windows 8),619,200,419,20,25.0,335.2
Microsoft Sudoku (Windows),405,200,205,20,200.0,20.5
Microsoft Sudoku (UWP),1938,1000,938,45,80.0,527.625
Microsoft Sudoku (JP) (Windows),258,200,58,20,80.0,14.5
Microsoft Sudoku (JP) (UWP),1322,1000,322,45,60.0,241.5
Microsoft Solitaire Collection (Windows),974,200,774,20,201.0,77.01492537313433
Microsoft Solitaire Collection (UWP),5876,1850,4026,76,350.0,874.2171428571429
Microsoft Minesweeper (Windows),2814,1000,1814,20,0.5,72560.0
Microsoft Minesweeper (Windows 8),604,200,404,20,41.0,197.0731707317073
Microsoft Mahjong (Windows),2128,1000,1128,40,50.0,902.4
Microsoft Mahjong (Windows 8),27,25,2,3,0.5,12.0
Microsoft Jigsaw (Windows),2976,1000,1976,20,60.0,658.6666666666666
Microsoft Jigsaw (Windows 8),607,200,407,20,200.0,40.7
Microsoft Jackpot (Windows),473,200,273,20,80.0,68.25
Microsoft Flight Simulator 2024,10697,1000,9697,27,34.0,7700.558823529412
Microsoft Flight Simulator,11134,1000,10134,43,1000.0,435.762
Microsoft Bingo (Windows),1865,1000,865,20,80.0,216.25
Microsoft Bingo (Windows 8),402,200,202,20,80.0,50.5
MiceGard (Windows),3234,3000,234,20,0.5,9360.0
Mia and the Dragon Princess,1169,1000,169,18,3.0,1014.0
Metro: Last Light Redux (Windows),2026,1000,1026,49,15.0,3351.6
Metro Exodus Enhanced Edition (Windows),1840,1100,740,52,50.0,769.6
Metro Exodus (Windows),3709,1100,2609,52,40.0,3391.7
Metro 2033 Redux (Windows),1665,1000,665,49,15.0,2172.3333333333335
Metaphor: ReFantazio,3450,1000,2450,44,100.0,1078.0
Metal: Hellsinger,2543,1000,1543,28,6.0,7200.666666666667
Metal Slug Tactics,9955,1000,8955,48,60.0,7164.0
Merge & Blade,26394,2600,23794,72,107.0,16010.915887850468
Meowsterpiece Museum (Windows),2047,2000,47,16,0.5,1504.0
Meow Moments: Celebrating Renewal & Romance,1062,1000,62,18,2.0,558.0
Meow Moments: Celebrating Geeks & Athletes,1035,1000,35,18,2.0,315.0
Megaton Rainfall,5404,1000,4404,14,13.0,4742.7692307692305
Mega Mall Story,1236,1000,236,10,10.0,236.0
Medieval Dynasty,4665,1000,3665,44,60.0,2687.6666666666665
Mechstermination Force,4777,1000,3777,19,28.0,2562.964285714286
Mecho Wars: Desert Ashes,1595,1000,595,13,12.0,644.5833333333334
Mecho Tales,1053,1000,53,11,2.0,291.5
MechWarrior 5: Mercenaries,2917,1000,1917,19,60.0,607.05
MechWarrior 5: Clans,3453,1000,2453,41,40.0,2514.325
McPixel 3,2038,1000,1038,93,8.0,12066.75
Mayhem Heroes,3278,3000,278,28,0.5,15568.0
Matsuro Palette,1285,1000,285,18,2.0,2565.0
Matchpoint: Tennis Championships,3828,1000,2828,23,15.0,4336.266666666666
Matchbox Driving Adventures,1224,1000,224,15,2.0,1680.0
Marvel's Guardians of the Galaxy: The Telltale Series (Windows),209,200,9,6,1.0,54.0
Marvel's Guardians of the Galaxy,1572,1000,572,58,20.0,1658.8
Marvel's Avengers,2714,1000,1714,50,80.0,1071.25
Marvel vs. Capcom: Infinite,6211,1000,5211,47,25.0,9796.68
Martha Is Dead,1699,1000,699,22,6.0,2563.0
Marshmallow Marvin: Timberfall (Windows),2029,2000,29,15,0.5,870.0
Marshmallow Marvin: Templestone (Windows),1008,1000,8,10,0.5,160.0
Marshmallow Marvin: Grimvault (Windows),2027,2000,27,15,0.5,810.0
Marshmallow Marvin: Greenwood (Windows),2016,2000,16,16,0.5,512.0
Marshmallow Marvin (Windows),2053,2000,53,55,0.5,5830.0
Mars Survivor,1145,1000,145,23,6.0,555.8333333333334
Mars Power Industries Deluxe,1328,1000,328,11,3.0,1202.6666666666667
Mark of the Deep,2200,1000,1200,10,35.0,342.85714285714283
Marenian Tavern Story: Patty and the Hungry God,1582,1000,582,49,60.0,475.3
March to a Million,1864,1000,864,10,30.0,288.0
Maquette,1847,1000,847,22,2.0,9317.0
Manor Lords (Windows),5728,1000,4728,11,25.0,2080.32
Mangavania 2 (Windows),1016,1000,16,20,0.5,640.0
Mangavania (Windows),1069,1000,69,20,0.5,2760.0
Maneater,1915,1000,915,32,10.0,2928.0
Mandragora: Whispers of the Witch Tree,3100,1000,2100,52,60.0,1820.0
Malu the Princess (Windows),2077,2000,77,27,0.5,4158.0
Make It Rain: The Love of Money (Windows),274,200,74,20,3.0,493.3333333333333
Mainframent (Windows),2053,2000,53,15,0.5,1590.0
Maid of Sker,5041,1200,3841,30,15.0,7682.0
Magical Girls vs Cat Aliens (Windows),2086,2000,86,15,0.5,2580.0
Magical Delicacy,3366,1000,2366,26,25.0,2460.64
Magical Backpack (Windows),3125,3000,125,45,0.5,11250.0
Magazine Mogul,1394,1000,394,10,8.0,492.5
Mafia: Definitive Edition (Windows),2763,1000,1763,43,15.0,5053.933333333333
Mad Streets,1657,1000,657,10,1.0,6570.0
Mad Experiments: Escape Room,1151,1000,151,13,0.5,3926.0
Machinetrix (Windows),2636,2000,636,15,1.0,9540.0
MUSYNX,2649,1000,1649,27,15.0,2968.2
MULLET MADJACK,2398,1000,1398,48,8.0,8388.0
MIDNIGHT Remastered,1281,1000,281,24,0.5,13488.0
METRO QUESTER | OSAKA,1259,1000,259,33,29.0,294.7241379310345
METRO QUESTER,1375,1000,375,32,40.0,300.0
Luna (Windows),1361,1000,361,17,1.0,6137.0
Lumines Remastered,9690,1000,8690,29,15.0,16800.666666666668
Lost in Random: The Eternal Die,5854,1000,4854,41,25.0,7960.56
Lost Words: Beyond the Page (Windows),1229,1000,229,21,4.0,1202.25
Lost Snowmen (Windows),5572,5000,572,35,0.5,40040.0
Lornsword Winter Chronicle,3564,1000,2564,20,32.0,1602.5
Lords of the Fallen,6713,1200,5513,72,85.0,4669.835294117647
Lord of the Click 5 (Windows),2165,2000,165,15,0.5,4950.0
Lord of the Click 4 (Windows),2101,2000,101,15,0.5,3030.0
Loot River,3583,1000,2583,15,6.0,6457.5
Loop Hero,3813,1000,2813,50,40.0,3516.25
Looney Tunes: Wacky World of Sports,2073,1000,1073,26,23.0,1212.9565217391305
Lonely Mountains: Snow Riders,33795,1425,32370,61,9.0,219396.66666666666
Lonely Mountains: Downhill,8768,1000,7768,47,25.0,14603.84
Little Triangle,3698,1000,2698,34,12.0,7644.333333333333
Little Town Hero,2671,1000,1671,44,31.0,2371.7419354838707
Little Noah: Scion of Paradise,2801,1000,1801,39,30.0,2341.3
Little Nightmares II Enhanced Edition (Windows),2734,1000,1734,35,5.0,12138.0
"Little Kitty, Big City",1670,1000,670,39,5.0,5226.0
Little Kite,1031,1000,31,15,1.0,465.0
Little Droid,1006,1000,6,20,0.5,240.0
Little Bear (Windows),3126,3000,126,45,0.5,11340.0
Little Ant Adventure (Windows),2069,2000,69,20,0.5,2760.0
Listeria Wars (Windows),3198,3000,198,20,0.5,7920.0
Lily in Puzzle World (Windows),3142,3000,142,22,0.5,6248.0
Lil Gator Game,1423,1000,423,22,4.0,2326.5
Like a Dragon: Pirate Yakuza in Hawaii,1230,1000,230,61,40.0,350.75
Like a Dragon: Ishin!,4337,1000,3337,55,120.0,1529.4583333333333
Like a Dragon: Infinite Wealth,1311,1000,311,64,80.0,248.8
Like a Dragon Gaiden: The Man Who Erased His Name,1563,1000,563,61,25.0,1373.72
Lightyear Frontier,6046,1750,4296,45,16.0,12082.5
Light-It Up,1431,1000,431,16,2.0,3448.0
Life is Strange: True Colors,1340,1000,340,40,8.0,1700.0
Life is Strange: Double Exposure,1625,1000,625,32,20.0,1000.0
Lies of P,2356,1000,1356,42,60.0,949.2
Liege Dragon,1529,1000,529,33,15.0,1163.8
Lichtspeer: Double Speer Edition,8422,1000,7422,20,25.0,5937.6
Library Of Ruina,15268,1000,14268,76,120.0,9036.4
Levelhead,9238,1000,8238,44,1837.0,197.31736526946108
Lethal League Blaze,4089,1000,3089,15,15.0,3089.0
Let's Build a Zoo,5464,1000,4464,33,60.0,2455.2
Lemon Cake,1965,1000,965,17,15.0,1093.6666666666667
Lemnis Gate (Windows),3489,1000,2489,31,50.0,1543.18
Legends Aligned: Minis in Conflict (Windows),2066,2000,66,24,0.5,3168.0
Legends Aligned (Windows),2044,2000,44,28,0.5,2464.0
Legend of the Tetrarchs,1337,1000,337,26,20.0,438.1
Legend of Mana,6491,1000,5491,29,35.0,4549.685714285714
Legend of Ixtona,2428,1000,1428,16,42.0,544.0
Legal Dungeon,1220,1000,220,10,10.0,220.0
Layers of Fear,2982,1000,1982,52,25.0,4122.56
Lawn Mowing Simulator,5761,1000,4761,42,60.0,3332.7
Launcher Heroes,1305,1000,305,10,3.0,1016.6666666666666
Late Shift,1461,1000,461,20,3.0,3073.3333333333335
Last Stop,1542,1000,542,35,6.0,3161.6666666666665
Last Labyrinth (Windows),1975,1000,975,35,7.0,4875.0
Last Escape: Dead Complex,1510,1000,510,10,4.0,1275.0
Last Call BBS (Windows),2049,1000,1049,10,15.0,699.3333333333334
Lake,1270,1000,270,10,6.0,450.0
Lab Crisis (Windows),5628,5000,628,30,0.5,37680.0
LUNAR Remastered Collection,2531,1000,1531,50,50.0,1531.0
LOUD: My Road to Fame,2436,1000,1436,21,26.0,1159.8461538461538
LIMBO (Windows),1850,1000,850,13,2.0,5525.0
LIGHTNING RETURNS: FINAL FANTASY XIII (Windows),2306,1000,1306,42,30.0,1828.4
LEGO Star Wars: The Skywalker Saga,3132,1000,2132,45,80.0,1199.25
LAPIN,3659,1000,2659,94,30.0,8331.533333333333
Kyub,23813,1500,22313,42,90.0,10412.733333333334
Kuznetsk 1997: Detective Visual Novel,1355,1000,355,10,5.0,710.0
Kunitsu-Gami: Path of the Goddess,4796,1000,3796,48,40.0,4555.2
Kulebra and the Souls of Limbo,2321,1000,1321,10,12.0,1100.8333333333333
Kubics (Windows),3217,3000,217,40,0.5,17360.0
Kraken Academy!!,1494,1000,494,48,6.0,3952.0
Kona II: Brume,2697,1000,1697,39,8.0,8272.875
Knowledge Keeper (Windows),1162,1000,162,15,1.0,2430.0
Knights of Grayfang,1221,1000,221,31,6.0,1141.8333333333333
Knights and Bikes,2902,1000,1902,36,10.0,6847.2
Knight Quest: Goblins Raid (Windows),2026,2000,26,25,0.5,1300.0
Kittens and Yarn,1393,1000,393,10,4.0,982.5
Kitten Island (Windows),3146,3000,146,25,0.5,7300.0
Kiting Cat (Windows),3097,3000,97,30,0.5,5820.0
Kingdoms & Lords (Windows),569,200,369,20,25.0,295.2
Kingdom Two Crowns,5271,1315,3956,33,22.0,5934.0
Kingdom Rush Origins,1708,1000,708,83,25.0,2350.56
Kingdom Rush Frontiers,1572,1000,572,85,25.0,1944.8
Kingdom Rush,1566,1000,566,74,20.0,2094.2
Kingdom Come: Deliverance (Windows),4478,1190,3288,53,150.0,1161.76
King of the Arcade,1120,1000,120,15,0.5,3600.0
King Leo,1043,1000,43,14,0.5,1204.0
Kinectimals Unleashed (Windows),302,200,102,10,25.0,40.8
Killer Instinct,11175,1560,9615,150,212.0,6803.066037735849
Killer Frequency,1625,1000,625,27,6.0,2812.5
Kill It With Fire,2355,1000,1355,24,4.0,8130.0
Kid Tripp,3550,1000,2550,20,6.0,8500.0
Keplerth (Windows),4478,1000,3478,58,113.0,1785.1681415929204
Kentucky Route Zero: TV Edition,2620,1000,1620,24,6.0,6480.0
Keeper's Toll,3030,2000,1030,53,31.0,1760.967741935484
Katamari Damacy Reroll (Windows),2509,1000,1509,21,20.0,1584.45
KarmaZoo,2756,1000,1756,22,30.0,1287.7333333333333
Kamiko,2264,1000,1264,27,4.0,8532.0
Kabaret,4087,1000,3087,67,75.0,2757.72
Justice Chronicles,1825,1000,825,20,20.0,825.0
Just Cause 4,4525,1000,3525,34,50.0,2397.0
Jusant,2431,1000,1431,21,6.0,5008.5
Jurassic World Evolution 2,6319,1050,5269,49,60.0,4303.016666666666
Jurassic Pinball,1179,1000,179,15,1.0,2685.0
Jumbo Airport Story,1377,1000,377,10,15.0,251.33333333333334
Jumanji: Wild Adventures,2276,1000,1276,41,39.0,1341.4358974358975
Journey to the Savage Planet: Employee of the Month Edition (Windows),2476,1000,1476,51,15.0,5018.4
Journey to Kreisia,1611,1000,611,31,15.0,1262.7333333333333
Journey of the Broken Circle,1547,1000,547,11,5.0,1203.4
Journey of Johann: Grasslands (Windows),2462,2000,462,22,0.5,20328.0
Jonah Lomu Rugby Challenge 4,2667,1000,1667,51,53.0,1604.0943396226414
Johnny Trigger,1391,1000,391,34,6.0,2215.6666666666665
Johnny Rocket,1111,1000,111,10,0.5,2220.0
JoJo's Bizarre Adventure: All-Star Battle R,3896,1000,2896,45,15.0,8688.0
Jinshin,1310,1000,310,30,10.0,930.0
Jetpack Joyride (Windows),339,200,139,20,6.0,463.3333333333333
Jeopardy! PlayShow,2367,1000,1367,11,12.0,1253.0833333333333
JYDGE,2701,1000,1701,15,20.0,1275.75
It Lurks Below,3626,1000,2626,20,20.0,2626.0
Isonzo,4453,1000,3453,45,60.0,2589.75
Island Trouble (Windows),1113,1000,113,70,1.0,7910.0
Island Farmer,1217,1000,217,20,3.0,1446.6666666666667
Island Cities - Jigsaw Puzzle,1262,1000,262,26,6.0,1135.3333333333333
Isekai Rondo,1514,1000,514,32,10.0,1644.8
Is this Game Trying to Kill Me? (Windows),1059,1000,59,17,1.0,1003.0
Irony Curtain: From Matryoshka with Love,1294,1000,294,42,5.0,2469.6
Into the Pit,1511,1000,511,10,12.0,425.8333333333333
Insurgency: Sandstorm,2957,1000,1957,30,15.0,3914.0
Instant War: Ultimate Warfare (Windows),4505,1800,2705,94,2500.0,101.708
Insomnis,1158,1000,158,27,0.5,8532.0
Inscryption,3421,1000,2421,40,40.0,2421.0
Inkulinati,3646,1000,2646,26,25.0,2751.84
Injustice 2 (Windows),5498,1045,4453,64,156.0,1826.871794871795
Infinity Strash: DRAGON QUEST The Adventure of Dai,2787,1000,1787,36,50.0,1286.64
Infinite Links,1478,1000,478,33,8.0,1971.75
Infinite Guitars,2991,1000,1991,33,10.0,6570.3
Infernitos: Fiery Dishes (Windows),2037,2000,37,27,0.5,1998.0
Infernitos (Windows),3087,3000,87,32,0.5,5568.0
Infernax,3281,1225,2056,42,16.0,5397.0
Indivisible (Windows),2485,1000,1485,29,15.0,2871.0
Indiana Jones and the Great Circle,2085,1000,1085,45,40.0,1220.625
In rays of the Light (Windows),1037,1000,37,15,1.0,555.0
Imperia Online (Windows),615,400,215,30,80.0,80.625
Immortality,2064,1000,1064,27,12.0,2394.0
Immortal Realms: Vampire Wars (Windows),4168,1000,3168,52,40.0,4118.4
Immortal Legacy: The Jade Cipher,2047,1000,1047,36,8.0,4711.5
Imagine Earth,3344,1050,2294,24,25.0,2202.24
Illusion of L'Phalcia,1360,1000,360,16,20.0,288.0
Icy Gifts (Windows),2040,2000,40,15,0.5,1200.0
Iconoclasts,2763,1000,1763,11,20.0,969.65
IceLine (Windows),3517,3000,517,20,0.5,20680.0
INSIDE,1441,1000,441,14,3.0,2058.0
INFERNO CLIMBER: REBORN (Windows),3879,1000,2879,34,198.0,494.37373737373736
I Saw Black Clouds,1312,1000,312,15,4.0,1170.0
I Expect You To Die (Windows),1626,1000,626,11,4.0,1721.5
I Did Not Buy This Ticket,1074,1000,74,30,0.5,4440.0
I Am the Hero,2937,1000,1937,35,18.0,3766.3888888888887
I Am Your Beast,4895,1000,3895,31,18.0,6708.055555555556
I Am Fish,13865,1000,12865,29,40.0,9327.125
Hypnospace Outlaw,2154,1000,1154,14,6.0,2692.6666666666665
HyperDot,3382,1000,2382,26,5.0,12386.4
Hyper Gunsport,1528,1000,528,11,4.0,1452.0
Hydro Thunder Hurricane (Windows),765,200,565,12,25.0,271.2
Hunt: Showdown 1896 (Windows),9796,1000,8796,36,77.0,4112.415584415585
Hungry Shark Evolution (Windows),405,200,205,6,10.0,123.0
Hundred Days - Winemaking Simulator,3673,1000,2673,31,59.0,1404.457627118644
Human Fall Flat Legacy (Windows),2943,1000,1943,63,8.0,15301.125
Human Fall Flat,18545,3720,14825,123,16.5,110513.63636363637
House Flipper,3961,1055,2906,26,15.0,5037.066666666667
Hot Wheels Unleashed 2 - Turbocharged,3161,1000,2161,43,15.0,6194.866666666667
Hot Wheels Unleashed,4319,1000,3319,44,20.0,7301.8
Hot Wheels Monster Trucks: Stunt Mayhem,1667,1000,667,19,8.0,1584.125
Hot Springs Story,1299,1000,299,10,20.0,149.5
Hot Rod Mayhem,2805,1400,1405,17,7.0,3412.1428571428573
Horrific Xanatorium,1010,1000,10,17,0.5,340.0
HoneyLand (Windows),2030,2000,30,27,0.5,1620.0
Homestead Arcana,3766,1000,2766,35,20.0,4840.5
Home Run High,2432,1000,1432,10,62.0,230.96774193548387
Hollow Knight: Voidheart Edition,3631,1000,2631,63,60.0,2762.55
Hole io,1516,1000,516,25,6.0,2150.0
Hole Theory (Xbox One & Windows),1000,1000,0,35,0.5,0.0
Hitman GO (Windows),333,200,133,20,6.0,443.3333333333333
Hitchhiker (Windows),3202,2500,702,50,5.0,7020.0
Hindsight,1103,1000,103,15,1.0,1545.0
High Sea Saga DX,1595,1000,595,10,94.0,63.297872340425535
High On Life,2338,1000,1338,32,20.0,2140.8
Higgs Boson: Puzzle Collection (Windows),2033,2000,33,23,0.5,1518.0
Hidden Paws Mystery,1262,1000,262,15,3.0,1310.0
Hidden Paws,1281,1000,281,28,3.0,2622.6666666666665
Hi-Fi RUSH,9365,1250,8115,71,68.0,8473.014705882353
Hexologic,1016,1000,16,11,1.0,176.0
Hexic (Windows),525,200,325,20,15.0,433.3333333333333
Hexapoda,2171,1000,1171,35,7.0,5855.0
Heroine Anthem ZERO 2: Scalescars Oath,4306,1000,3306,71,59.0,3978.406779661017
Hero Survival (Windows),1156,1000,156,23,8.0,448.5
Her Story (Windows),1077,1000,77,13,0.5,2002.0
Hello Neighbor 2,1801,1000,801,14,1.0,11214.0
Hello Neighbor,1706,1000,706,17,8.0,1500.25
Hellblade: Senua's Sacrifice (Windows),1588,1000,588,14,6.0,1372.0
Hell Let Loose,20793,1825,18968,83,120.0,13119.533333333333
Helix Jump,1739,1000,739,23,5.0,3399.4
Heirs of the Kings,1492,1000,492,33,15.0,1082.4
Hegzis,3056,1000,2056,20,26.0,1581.5384615384614
Heart Box (Windows),2597,1000,1597,34,15.0,3619.866666666667
Headliner: NoviNews,1543,1000,543,58,12.0,2624.5
Headbutt Factory (Windows),1347,1000,347,14,2.0,2429.0
Headbangers: Rhythm Royale,12038,1200,10838,28,40.0,7586.6
Haven,3339,1000,2339,30,15.0,4678.0
Have a Nice Death,8470,1000,7470,37,60.0,4606.5
Hauntii,2879,1000,1879,40,15.0,5010.666666666667
Hatsune Miku Logic Paint S,1518,1000,518,11,15.0,379.8666666666667
Hatsune Miku Jigsaw Puzzle,1600,1000,600,10,60.0,100.0
Hatsune Miku - The Planet Of Wonder And Fragments Of Wishes,1914,1000,914,20,9.0,2031.111111111111
Harvest Moon: Mad Dash,2453,1000,1453,27,58.0,676.3965517241379
Harvest Moon: Light of Hope Special Edition Complete,3775,1000,2775,28,246.0,315.8536585365854
Harumachi Toroidal,1364,1000,364,31,11.0,1025.8181818181818
Harold Halibut,2260,1000,1260,27,15.0,2268.0
Hardspace: Shipbreaker,3826,1560,2266,27,50.0,1223.64
Happy Words,2919,1000,1919,24,19.0,2424.0
Happy Wars,8944,1500,7444,57,105.0,4041.0285714285715
Happi Basudei (Windows),4860,4000,860,26,0.5,44720.0
Hanoi Puzzles: Solid Match,1199,1000,199,11,0.5,4378.0
Halo: The Master Chief Collection,19209,5090,14119,510,581.0,12393.614457831325
Halo: Spartan Strike (Windows),449,200,249,20,10.0,498.0
Halo: Spartan Assault (Windows),604,250,354,25,9.0,983.3333333333334
Halo Wars: Definitive Edition,4926,1500,3426,75,25.0,10278.0
Halo Wars 2,3287,1060,2227,60,61.0,2190.4918032786886
Halo Infinite,1281,600,681,50,80.0,425.625
Halo 5: Forge (Windows),2025,1000,1025,22,6.0,3758.3333333333335
Halloween Pinball,1912,1000,912,15,6.0,2280.0
Hades,2390,1000,1390,49,60.0,1135.1666666666667
HUMANITY,2958,1000,1958,54,20.0,5286.6
HITMAN World of Assassination,3259,1000,2259,47,25.0,4246.92
GyroShooter VR (Windows),1274,1000,274,13,2.0,1781.0
Gunscape,2165,1000,1165,44,12.0,4271.666666666667
Gunpowder (Windows),339,200,139,20,5.0,556.0
Gunma's Ambition -You and me are Gunma- Reiwa 2nd national census edition,1117,1000,117,20,1.0,2340.0
Gungrave G.O.R.E,4696,1045,3651,52,18.0,10547.333333333334
Guilty Gear -Strive-,3743,1000,2743,38,15.0,6948.933333333333
Guazu: The Rescue,2363,2000,363,40,1.0,14520.0
Guardian of the Water Altar (Windows),2053,2000,53,35,0.5,3710.0
Guacamelee! 2,2615,1000,1615,36,15.0,3876.0
Grounded,9654,3300,6354,45,0.5,571860.0
Grizzly Bear is Hungry (Windows),1014,1000,14,10,0.5,280.0
Grim Fandango Remastered,1981,1000,981,48,8.0,5886.0
Green Soldiers Heroes (Windows),2020,2000,20,15,0.5,600.0
GreedFall (Windows),3749,1000,2749,58,60.0,2657.366666666667
Graze Counter GM,2073,1000,1073,18,4.0,4828.5
Gravity Thrust,3413,1000,2413,12,5.0,5791.2
Gravity Guy (Windows),770,200,570,20,10.0,1140.0
Grand Theft Auto V Enhanced (Windows),8890,1750,7140,77,0.5,1099560.0
Grand Theft Auto V (Windows),4712,1750,2962,77,200.0,1140.37
Grand Prix Story,1404,1000,404,10,15.0,269.3333333333333
Grace of Letoile,1340,1000,340,15,8.0,637.5
Gotham Knights,4587,1390,3197,61,52.0,3750.326923076923
Gorogoa,1589,1000,589,11,1.0,6479.0
Gori: Cuddly Carnage,2976,1000,1976,34,15.0,4478.933333333333
Goodwill Scrolls (Windows),2050,2000,50,20,0.5,2000.0
Golfing in Aether,3035,1000,2035,22,21.0,2131.904761904762
Golf With Your Friends (Windows),3790,1135,2655,42,9.0,12390.0
Golf Up,1824,1000,824,14,6.0,1922.6666666666667
Going Under,3975,1050,2925,23,20.0,3363.75
Godsvivors (Windows),3164,3000,164,31,1.0,5084.0
God of Light: Remastered,2072,1000,1072,41,8.0,5494.0
Goat Simulator: Remastered,2100,1000,1100,41,8.0,5637.5
Goat Simulator 3,3063,1000,2063,39,15.0,5363.8
Goat Simulator (Windows),1789,1000,789,30,3.0,7890.0
Go Mecha Ball,6589,1000,5589,29,20.0,8104.05
Glorious Savior,1597,1000,597,30,29.0,617.5862068965517
Glitch Hero,1338,1000,338,11,4.0,929.5
Glacier Blast (Windows),355,200,155,20,2.0,1550.0
Gimme Five (Windows),1645,1000,645,50,80.0,403.125
Gigantosaurus: Dino Sports,1172,1000,172,13,3.0,745.3333333333334
Gigantic: Rampage Edition,13826,1000,12826,26,247.0,1350.1052631578948
Gigantic,8913,1000,7913,26,150.0,1371.5866666666666
Ghostwire: Tokyo,3958,1180,2778,66,60.0,3055.8
Ghostlore,5461,1000,4461,33,50.0,2944.26
Ghost of a Tale (Windows),4401,1000,3401,20,20.0,3401.0
Ghost Sync,1454,1000,454,32,10.0,1452.8
Ghost Song,2262,1000,1262,42,15.0,3533.6
Genso Chronicles,1497,1000,497,34,15.0,1126.5333333333333
Generation Zero,3659,1030,2629,51,40.0,3351.975
Gears of War: Ultimate Edition (Windows),7182,1250,5932,56,242.0,1372.6942148760331
Gears of War 4,21657,4000,17657,164,458.0,6322.593886462882
Gears Tactics,10864,1400,9464,61,100.0,5773.04
Gears POP!,3672,1000,2672,45,1000.0,120.24
Gears 5,17618,2410,15208,166,3320.0,760.4
Garden Story,3251,1000,2251,21,15.0,3151.4
Gang Beasts,1927,1000,927,19,1.0,17613.0
Game Dev Story,1412,1000,412,10,10.0,412.0
Gambit Shifter (Windows),1078,1000,78,26,1.0,2028.0
Gale of Windoria,1311,1000,311,29,15.0,601.2666666666667
Galaxy Kingdoms (Windows),3216,3000,216,30,0.5,12960.0
Galaxy Control: Arena,4208,1000,3208,10,150.0,213.86666666666667
Galacticare,9172,1185,7987,54,40.0,10782.45
Galactic Reign (Windows),284,200,84,20,1.0,1680.0
Galactic Loader (Windows),2141,2000,141,15,0.5,4230.0
Galactic Civilizations III (Windows),4881,1075,3806,68,126.0,2054.031746031746
Gabriels Worlds The Adventure (Windows),4294,4000,294,31,0.5,18228.0
GUNBIRD 2,2265,1000,1265,26,2.0,16445.0
GUNBIRD,2272,1000,1272,27,2.0,17172.0
GRAPPIN,1817,1000,817,14,7.0,1634.0
GODS Remastered,4386,1000,3386,46,12.0,12979.666666666666
GNOSIA,1466,1000,466,27,20.0,629.1
Fusion Paradox (Windows),1149,1000,149,15,2.0,1117.5
Full Throttle Remastered,1273,1000,273,40,2.0,5460.0
Full Metal Furies,3303,1000,2303,36,20.0,4145.4
Fuga: Melodies of Steel 3,1618,1000,618,44,47.0,578.5531914893617
Fuga: Melodies of Steel 2,2740,1000,1740,41,25.0,2853.6
Fuga: Melodies of Steel,2957,1000,1957,43,40.0,2103.775
Fruit Ninja (Windows),262,200,62,20,2.0,620.0
Fruit Adventure Returns (Windows),2091,2000,91,19,0.5,3458.0
Fruit Adventure (Windows),5262,5000,262,52,0.5,27248.0
Frozen Gauntlet (Windows),3225,3000,225,30,0.5,13500.0
Frozen Axe (Windows),1000,1000,0,30,0.5,0.0
Frostpunk 2 (Windows),12177,1450,10727,58,72.0,8641.194444444445
Frostpunk (Windows),6641,1485,5156,75,58.0,6667.241379310345
From Space,5772,1230,4542,32,55.0,2642.6181818181817
Frog Detective: The Entire Mystery,1352,1000,352,18,2.0,3168.0
Fritz - Don't call me a chess bot,1777,1105,672,41,8.0,3444.0
Frane: Dragons' Odyssey,1482,1000,482,24,12.0,964.0
FragPunk,35601,1000,34601,20,0.5,1384040.0
Foxes Need to Eat (Windows),4141,4000,141,30,0.5,8460.0
Fox Legend (Windows),2092,2000,92,15,0.5,2760.0
Forza Street,2599,1000,1599,12,150.0,127.92
Forza Motorsport 7,3568,1000,2568,62,120.0,1326.8
Forza Motorsport 6: Apex (Windows),2560,1000,1560,24,8.0,4680.0
Forza Motorsport,3438,1000,2438,57,120.0,1158.05
Forza Horizon 5,10101,2025,8076,110,98.0,9064.897959183674
Forza Horizon 4,8233,2560,5673,122,101.0,6852.534653465346
Forza Horizon 3,4036,1500,2536,68,61.0,2827.0163934426228
Forspoken (Windows),2400,1000,1400,53,40.0,1855.0
Forklift Extreme: Deluxe Edition,5615,1000,4615,13,37.0,1621.4864864864865
Forgotton Anne (Windows),1278,1000,278,33,8.0,1146.75
Forest Golf Planner,1568,1000,568,10,15.0,378.6666666666667
Forest Camp Story,1665,1000,665,10,28.0,237.5
For The Warp,1918,1000,918,10,26.0,353.0769230769231
For The King II,7067,1000,6067,72,129.0,3386.232558139535
For The King (Windows),5068,1000,4068,72,83.0,3528.867469879518
Football Manager 2024 Console,2195,1000,1195,41,15.0,3266.3333333333335
Football Manager 2024 (Windows),3239,1000,2239,100,200.0,1119.5
Football Manager 2023 Console,2280,1000,1280,41,15.0,3498.6666666666665
Football Manager 2023 (Windows),4434,1000,3434,100,200.0,1717.0
Football Manager 2022 Xbox Edition,3912,1000,2912,94,200.0,1368.64
Football Manager 2022 (Windows),4804,1000,3804,98,300.0,1242.64
Football Manager 2021 Xbox Edition,3873,1000,2873,94,80.0,3375.775
Football Manager 2021 (Windows),4179,1000,3179,98,150.0,2076.9466666666667
Football Manager 2020 (Windows),3819,1000,2819,89,200.0,1254.455
Football Manager 2019 (Windows),3925,1000,2925,75,434.0,505.47235023041475
Flynn: Son of Crimson,2272,1000,1272,22,6.0,4664.0
Fluffy Milo (Windows),4631,4000,631,28,0.5,35336.0
Floppy Knights,2873,1000,1873,18,20.0,1685.7
Floor Plan: Hands-On Edition (Windows),1099,1000,99,10,1.0,990.0
Flock,2937,1000,1937,44,12.0,7102.333333333333
FlipCat (Windows),2140,2000,140,15,0.5,4200.0
Flintlock: The Siege of Dawn,2082,1000,1082,38,15.0,2741.0666666666666
Flint: Treasure of Oblivion,2088,1000,1088,41,14.0,3186.285714285714
Flat Heroes,4074,1000,3074,44,32.0,4226.75
Flaskoman (Windows),2070,2000,70,15,0.5,2100.0
Five Nights at Freddy's: Sister Location,4452,1000,3452,10,15.0,2301.3333333333335
Five Nights at Freddy's 4,5082,1000,4082,10,6.0,6803.333333333333
Five Nights at Freddy's 3,4234,1000,3234,10,8.0,4042.5
Five Nights at Freddy's 2,1897,1000,897,10,1.0,8970.0
Five Nights at Freddy's,2395,1000,1395,10,1.0,13950.0
Five Dates,1228,1000,228,15,4.0,855.0
Fit and Fry (Windows),2038,2000,38,27,0.5,2052.0
Fishing Planet,33784,1000,32784,17,2007.0,277.69207772795215
Fishdom 3: Special Edition (Windows),249,200,49,20,25.0,39.2
Firework (Windows),1200,1000,200,10,3.0,666.6666666666666
Firewatch,1293,1000,293,10,4.0,732.5
Firefighting Simulator - The Squad,5495,1000,4495,30,60.0,2247.5
Fire: Ungh's Quest (Windows),1092,1000,92,27,2.0,1242.0
Figment: Journey Into the Mind,1759,1000,759,23,6.0,2909.5
Figment 2: Creed Valley,1551,1000,551,18,6.0,1653.0
Field & Stream Fishing (Windows),302,200,102,20,8.0,255.0
Fernz Gate,1586,1000,586,32,20.0,937.6
Fearful Symmetry & The Cursed Prince,1285,1000,285,46,2.0,6555.0
Fear Dog The Bolota Escape (Windows),1000,1000,0,10,0.5,0.0
Fate Seeker II,3190,1000,2190,93,65.0,3133.3846153846152
Farworld Pioneers,2403,1000,1403,10,6.0,2338.3333333333335
Farming Simulator 25 (Windows),2635,1000,1635,45,129.0,570.3488372093024
Farming Simulator 22 (Windows),3796,1000,2796,45,30.0,4194.0
Farming Simulator 19 (Windows),2537,1000,1537,23,20.0,1767.55
Farming Simulator 17 (Windows),1729,1000,729,17,10.0,1239.3
Farmer Survivors (Windows),3160,3000,160,30,1.0,4800.0
Farm Builder,2480,1000,1480,26,12.0,3206.6666666666665
Farlands Journey (Windows),2135,2000,135,15,1.0,2025.0
Fantastic Contraption (Windows),2199,1000,1199,12,14.0,1027.7142857142858
Fallout Shelter,2506,1000,1506,35,80.0,658.875
Fallout 76 (Windows),7607,1580,6027,72,112.0,3874.5
Fallout 4 (Windows),2194,1000,1194,50,6.0,9950.0
Fall Asleep (Windows),2301,2000,301,15,0.5,9030.0
Fairy Elements,1474,1000,474,30,12.0,1185.0
Faeria (Windows),5334,1000,4334,54,127.0,1842.8031496062993
Factory Escape (Windows),3110,3000,110,30,0.5,6600.0
Fable Fortune,2985,1000,1985,17,80.0,421.8125
FRONT MISSION 1st: Remake,3537,1000,2537,29,60.0,1226.2166666666667
FORM (Windows),1230,1000,230,10,1.0,2300.0
FINAL FANTASY XVI,5040,1000,4040,50,80.0,2525.0
FINAL FANTASY XV POCKET EDITION (Windows),353,160,193,18,25.0,138.96
FINAL FANTASY XV,1892,1020,872,52,61.0,743.344262295082
FINAL FANTASY XIII-2 (Windows),2037,1000,1037,31,40.0,803.675
FINAL FANTASY XIII (Windows),3311,1000,2311,35,60.0,1348.0833333333333
FINAL FANTASY XII THE ZODIAC AGE (Windows),3392,1000,2392,40,80.0,1196.0
FINAL FANTASY X/X-2 HD Remaster (Windows),4069,1000,3069,67,200.0,1028.115
FINAL FANTASY VIII Remastered (Windows),2231,1000,1231,34,20.0,2092.7
FINAL FANTASY VII (Windows),2775,1000,1775,31,20.0,2751.25
FINAL FANTASY VI,1837,1000,837,36,25.0,1205.28
FINAL FANTASY V,1409,1000,409,38,25.0,621.68
FINAL FANTASY IX,3395,1000,2395,51,60.0,2035.75
FINAL FANTASY IV,1321,1000,321,29,15.0,620.6
FINAL FANTASY III,1259,1000,259,30,15.0,518.0
FINAL FANTASY II,1260,1000,260,27,15.0,468.0
FINAL FANTASY,1207,1000,207,23,10.0,476.1
FIFA 15 Ultimate Team (Windows),383,200,183,20,10.0,366.0
FIFA 14 (Windows),352,200,152,20,10.0,304.0
FBC: Firebreak,4440,1000,3440,43,15.0,9861.333333333334
FAR: Changing Tides (Windows),2374,1000,1374,35,4.0,12022.5
F1 Manager 2023,2663,1000,1663,29,20.0,2411.35
F1 2019 (Windows),4108,1000,3108,47,40.0,3651.9
F1 2018 (Windows),3518,1000,2518,49,40.0,3084.55
F.I.S.T.: Forged in Shadow Torch,3172,1000,2172,43,15.0,6226.4
Eyes: The Horror Game,1718,1000,718,28,3.0,6701.333333333333
Expeditions: Rome (Windows),4784,910,3874,60,117.0,1986.6666666666667
Expeditions: A MudRunner Game,5156,1000,4156,20,60.0,1385.3333333333333
Exoprimal,2815,1000,1815,39,80.0,884.8125
Exodus: Creepy Time (Windows),2064,2000,64,15,0.5,1920.0
Exo One,5126,1000,4126,28,8.0,14441.0
ExZeus 2 (Windows),286,200,86,20,15.0,114.66666666666667
Eville,4504,1000,3504,42,222.0,662.918918918919
Evil West,3126,1000,2126,29,20.0,3082.7
Evil Genius 2: World Domination,8086,1000,7086,90,120.0,5314.5
Europa Universalis IV (Windows),14157,1273,12884,261,4963.0,677.5587346363087
Eternal Strands,4338,1000,3338,44,40.0,3671.8
Eternal Return (Windows),3334,1000,2334,69,55.0,2928.109090909091
Eternal Card Game,16368,2940,13428,176,897.0,2634.7023411371238
Escape from the Dungeon (Windows),3155,3000,155,40,0.5,12400.0
Escape Sequence (Windows),2094,2000,94,22,0.5,4136.0
Escape First Alchemist,1209,1000,209,10,1.0,2090.0
Escape First 3 Multiplayer,1085,1000,85,11,0.5,1870.0
Escape First 2,1099,1000,99,10,0.5,1980.0
Escape First,1165,1000,165,10,0.5,3300.0
Escape Dash Journey (Windows),2105,2000,105,46,0.5,9660.0
Escape Academy,4813,1500,3313,40,7.0,18931.428571428572
Escape 2088,1043,1000,43,10,0.5,860.0
Epic Astro Story,1311,1000,311,10,15.0,207.33333333333334
Enter the Gungeon,5996,1250,4746,54,120.0,2135.7
Energy Cycle (Windows),1004,1000,4,10,0.5,80.0
Endless Space 2 (Windows),3885,1000,2885,77,80.0,2776.8125
Endless Skater (Windows),628,200,428,20,6.0,1426.6666666666667
Endless Legend (Windows),1014,1000,14,71,0.5,1988.0
Empire of the Ants,5493,1000,4493,41,38.0,4847.710526315789
Empire of Sin (Windows),4917,1000,3917,46,80.0,2252.275
Embr,4240,1000,3240,29,20.0,4698.0
Elon and the Divine Proof (Windows),2083,2000,83,15,0.5,2490.0
Ellphaser (Windows),2042,2000,42,27,0.5,2268.0
Elemental War TD,3430,1000,2430,61,155.0,956.3225806451613
Elemental War 2,4125,1000,3125,42,95.0,1381.578947368421
ElecHead,1208,1000,208,13,1.0,2704.0
Eldgear,2331,1000,1331,40,41.0,1298.5365853658536
Eiyuden Chronicle: Rising,1842,1000,842,50,20.0,2105.0
Eiyuden Chronicle: Hundred Heroes,3510,1000,2510,56,120.0,1171.3333333333333
Educational Games for Kids,1612,1000,612,34,3.0,6936.0
Edge of Reality (Windows),1000,1000,0,17,0.5,0.0
Echo Generation,1898,1000,898,50,6.0,7483.333333333333
Eastward,4896,1000,3896,30,40.0,2922.0
Eastshade,3133,1000,2133,18,8.0,4799.25
Eastern Exorcist,3657,1000,2657,38,15.0,6731.066666666667
EXAPUNKS (Windows),1523,1000,523,16,8.0,1046.0
EVERSPACE 2,5197,1000,4197,38,60.0,2658.1
EVERSPACE,6351,1000,5351,25,50.0,2675.5
ELDERBORN,7340,1000,6340,26,27.0,6105.185185185185
Dyson Sphere Program (Windows),11481,1355,10126,128,200.0,6480.64
Dungeons of Shalnor,1923,1000,923,18,12.0,1384.5
Dungeons of Hinterberg,3559,1275,2284,50,19.0,6010.526315789473
Dungeons 4,3267,1000,2267,61,40.0,3457.175
Dungeon of the Endless (Windows),4586,1000,3586,30,72.0,1494.1666666666667
Dungeon Village 2,1577,1000,577,10,27.0,213.7037037037037
Dungeon Village,1292,1000,292,10,10.0,292.0
Dungeon Hunter 5 (Windows),441,200,241,20,80.0,60.25
Dune: Spice Wars,5195,1000,4195,26,20.0,5453.5
Ducky Dash (Windows),3232,3000,232,45,0.5,20880.0
Duck Run (Windows),3329,3000,329,29,0.5,19082.0
Duck Detective: The Secret Salami,1045,1000,45,10,1.0,450.0
Duck Detective: The Ghost of Glamping,1056,1000,56,11,1.0,616.0
Dual Paths (Windows),2045,2000,45,15,0.5,1350.0
Drone Gladiator (Windows),2025,2000,25,15,0.5,750.0
Dreamscaper,4786,1000,3786,45,40.0,4259.25
Dream Town Island,1984,1000,984,18,20.0,885.6
Dream House Days DX,1772,1000,772,10,19.0,406.3157894736842
Drawngeon: Dungeons of Ink and Paper,6292,5000,1292,47,6.0,10120.666666666666
Drake Hollow,3764,1000,2764,50,20.0,6910.0
DragonFangZ - The Rose & Dungeon of Time,3993,1000,2993,32,71.0,1348.9577464788733
Dragon's Lair (Windows),277,200,77,12,3.0,308.0
Dragon Takers,1596,1000,596,31,13.0,1421.2307692307693
Dragon Sinker: Descendants of Legend,2191,1000,1191,30,15.0,2382.0
Dragon Prana,1512,1000,512,31,10.0,1587.2
Dragon Pinball,2200,1000,1200,15,3.0,6000.0
Dragon Mania Legends (Windows),318,200,118,17,40.0,50.15
Dragon Lapis,1566,1000,566,40,20.0,1132.0
Dragon Blaze,2317,1000,1317,32,4.0,10536.0
Dragon Ball Xenoverse 2,2615,1090,1525,55,88.0,953.125
Dragon Ball FighterZ (Windows),6144,1000,5144,35,147.0,1224.7619047619048
Draconic Resurgence (Windows),3244,3000,244,20,0.5,9760.0
Dr. Atominus (Windows),2020,2000,20,15,0.5,600.0
Downwell (Windows),4833,1000,3833,22,15.0,5621.733333333334
Double Kick Heroes,4662,1000,3662,38,8.0,17394.5
Double Dragon 4,3013,1000,2013,30,12.0,5032.5
Doritos Crash Course GO (Windows),315,200,115,13,2.0,747.5
Dordogne,1644,1000,644,31,3.0,6654.666666666667
Doraemon Dorayaki Shop Story,1719,1000,719,18,53.0,244.18867924528303
Doom & Destiny Worlds,5869,1000,4869,31,71.0,2125.9014084507044
Doom & Destiny,2404,1000,1404,44,30.0,2059.2
Doodle Mafia: Crime City,1121,1000,121,14,2.0,847.0
Doodle God: Evolution,1312,1000,312,29,3.0,3016.0
Doodle God Blitz HD (Windows),302,200,102,20,6.0,340.0
Doodle Devil: 3volution,1241,1000,241,14,40.0,84.35
Donut County,1408,1000,408,20,1.0,8160.0
Don't Starve: Giant Edition,1285,1000,285,10,0.5,5700.0
Dolmenjord - Viking Islands,1330,1000,330,11,3.0,1210.0
Dogurai,3324,1000,2324,30,6.0,11620.0
Dodgeball Academia,1803,1000,803,37,6.0,4951.833333333333
Doctor Cat (Windows),4542,4000,542,36,1.0,19512.0
Disneyland Adventures,4408,1000,3408,49,40.0,4174.8
Disney The Little Mermaid: Undersea Treasures! (Windows),28,25,3,3,0.5,18.0
Disney Speedstorm,2050,1000,1050,24,60.0,420.0
Disney Infinity: Toy Box (Windows),276,200,76,11,1.0,836.0
Disney Infinity 3.0 Edition (Windows),1473,1000,473,15,15.0,473.0
Disney Illusion Island Starring Mickey & Friends,2948,1000,1948,52,33.0,3069.5757575757575
Disney Fairies Hidden Treasures (Windows),209,200,9,20,1.0,180.0
Disney Dreamlight Valley,2067,1000,1067,15,200.0,80.025
Dishonored: Death of the Outsider (Windows),2030,1000,1030,30,12.0,2575.0
Dishonored Definitive Edition (Windows),5284,1640,3644,80,40.0,7288.0
Dishonored 2 (Windows),3233,1000,2233,50,25.0,4466.0
Disgaea 4 Complete+ (Windows),12564,1000,11564,51,120.0,4914.7
Disc Room,2589,1000,1589,35,4.0,13903.75
Dinosaur Fossil Hunter - Paleontology Simulator,2920,1000,1920,79,77.0,1969.8701298701299
Die for Valhalla!,2074,1000,1074,38,12.0,3401.0
Die Again,2176,1000,1176,19,2.0,11172.0
Dicey Dungeons,3191,1000,2191,53,40.0,2903.075
Dice Assassin (Windows),2157,2000,157,27,0.5,8478.0
DiRT Rally 2.0 (Windows),3801,1000,2801,50,66.0,2121.969696969697
Detective From The Crypt (Windows),1007,1000,7,46,1.0,322.0
Destroy All Humans! (Windows),2270,1000,1270,40,8.0,6350.0
Destiny 2,1634,1000,634,13,80.0,103.025
Despot's Game,5487,1000,4487,35,30.0,5234.833333333333
Despicable Me: Minion Rush (Windows),663,200,463,20,120.0,77.16666666666667
Desperados III (Windows),2129,1000,1129,36,40.0,1016.1
Descenders,14034,1500,12534,40,100.0,5013.6
Depersonalization (Windows),4978,1000,3978,73,134.0,2167.1194029850744
Demons of Asteborg,4294,1000,3294,35,15.0,7686.0
Demon's Tilt,4594,1000,3594,29,15.0,6948.4
Deiland: Pocket Planet,1481,1000,481,23,12.0,921.9166666666666
Defunct,4495,1000,3495,27,12.0,7863.75
Deep Space Anomaly (Windows),3129,3000,129,20,0.5,5160.0
Deep Rock Galactic,4415,1000,3415,67,300.0,762.6833333333333
Debtor: Enhanced Edition (Windows),5478,5000,478,30,0.5,28680.0
Death's Door (Windows),1575,1000,575,24,10.0,1380.0
Death and Taxes,3035,1000,2035,58,18.0,6557.222222222223
Death Come True,1052,1000,52,16,0.5,1664.0
Dead by Daylight (Windows),22735,4040,18695,209,548.5,7123.527803099362
Dead Rising 4 (Windows),11578,1650,9928,71,21.0,33566.09523809524
Dead Island 2 (Windows),3081,1040,2041,47,50.0,1918.54
Dead Ground (Windows),2170,2000,170,15,0.5,5100.0
Dead Dungeon (Windows),1324,1000,324,20,2.0,3240.0
Dead Dragons,1265,1000,265,25,6.0,1104.1666666666667
Dead Cells (Windows),7137,1360,5777,69,30.5,13069.27868852459
Day of the Tentacle Remastered,1411,1000,411,58,2.0,11919.0
Darksiders III (Windows),2600,1090,1510,53,30.0,2667.6666666666665
Darksiders Genesis (Windows),2266,1000,1266,30,25.0,1519.2
Darkest Dungeon II,9594,1590,8004,99,218.0,3634.8440366972477
Darkest Dungeon (Windows),4648,1000,3648,52,25.0,7587.84
Dark Grim Mariupolis (Windows),1011,1000,11,10,0.5,220.0
Dark Elven Legacy (Windows),3156,3000,156,40,0.5,12480.0
Dark Burial: Enhanced Edition (Windows),2146,2000,146,15,0.5,4380.0
Dark Alliance,4073,1000,3073,48,60.0,2458.4
Danger!Energy (Windows),1005,1000,5,15,0.5,150.0
Danger Goat (Windows),1557,1000,557,23,5.0,2562.2
Danger Gazers (Windows),1004,1000,4,10,0.5,80.0
Danganronpa: Trigger Happy Havoc Anniversary Edition,2823,1000,1823,38,40.0,1731.85
Danganronpa V3: Killing Harmony Anniversary Edition,2842,1000,1842,41,80.0,944.025
Danganronpa 2: Goodbye Despair Anniversary Edition,2233,1000,1233,47,50.0,1159.02
Dandy Ace,5194,1000,4194,26,20.0,5452.2
Dance of Cards,2457,1000,1457,16,22.0,1059.6363636363637
DYNABLASTER,1132,1000,132,21,2.0,1386.0
DREDGE,2008,1000,1008,40,15.0,2688.0
DRAGON QUEST XI S: Echoes of an Elusive Age - Definitive Edition (JP),1687,1000,687,58,80.0,498.075
DRAGON QUEST XI S: Echoes of an Elusive Age - Definitive Edition,3126,1000,2126,57,100.0,1211.82
DRAGON QUEST III HD-2D Remake,2238,1000,1238,42,50.0,1039.92
DRAGON QUEST Builders 2,3719,1000,2719,31,80.0,1053.6125
DPS Idle (Windows),3140,3000,140,21,1.0,2940.0
DOOM: The Dark Ages,1900,1000,900,28,15.0,1680.0
DOOM II (Classic),3786,1000,2786,19,40.0,1323.35
DOOM Eternal (Windows),3632,1045,2587,36,26.0,3582.0
DOOM 64,1479,1000,479,10,1.0,4790.0
DOOM 3,3199,1000,2199,44,25.0,3870.24
DOOM + DOOM II,2383,1000,1383,33,3.0,15213.0
DOOM (1993),3438,1000,2438,19,10.0,4632.2
DJMAX Respect V,14455,1000,13455,52,300.0,2332.2
DISORDER,2201,1000,1201,17,16.0,1276.0625
DIRT 5,2639,1000,1639,20,20.0,1639.0
DEEEER Simulator: Your Average Everyday Deer Game,1603,1000,603,17,1.0,10251.0
DEATHLOOP,3676,1000,2676,58,25.0,6208.32
DEATH STRANDING DIRECTOR'S CUT,3336,1000,2336,63,80.0,1839.6
DEATH STRANDING (Windows),4145,1000,3145,63,80.0,2476.6875
DE-EXIT - Eternal Matters,5224,1000,4224,29,8.0,15312.0
DC League of Super-Pets: The Adventures of Krypto and Ace,1316,1000,316,15,2.0,2370.0
DARKGEMS (Windows),4353,4000,353,27,0.5,19062.0
CyberTD,1980,1000,980,42,43.0,957.2093023255813
CyberHive (Windows),1698,1000,698,21,13.0,1127.5384615384614
Cyber Tank Nano (Windows),2242,2000,242,15,1.0,3630.0
Cyber Tank 2 (Windows),1349,1000,349,10,4.0,872.5
Cyber Tank (Windows),1159,1000,159,10,1.0,1590.0
Cyber Shadow,4386,1000,3386,40,15.0,9029.333333333334
Cut The Rope (Windows),406,200,206,19,2.0,1957.0
Curse of the Dead Gods (Windows),5922,1000,4922,30,61.0,2420.655737704918
Curious Cases,1107,1000,107,10,0.5,2140.0
Cuphead,2619,1025,1594,29,20.0,2311.3
Cuisineer,2382,1000,1382,52,44.0,1633.2727272727273
Crystal Rift (Windows),2867,1000,1867,41,30.0,2551.5666666666666
Crystal Ortha,1394,1000,394,26,12.0,853.6666666666666
Crystal Ball of Firmament (Windows),2218,2000,218,22,0.5,9592.0
Crypt Custodian,2298,1000,1298,48,12.0,5192.0
CrushBorgs (Windows),2346,2000,346,15,0.5,10380.0
Crusader Kings III (Windows),4725,1029,3696,60,158.0,1403.5443037974683
Cross Tails,2178,1000,1178,49,58.0,995.2068965517242
Croc's World Construction Kit 2,1037,1000,37,10,0.5,740.0
Croc's World 4,1985,1000,985,10,2.0,4925.0
Cris Tales (Windows),3106,1000,2106,46,25.0,3875.04
Crime Scene Cleaner,1666,1000,666,50,15.0,2220.0
Cricket 24 (Windows),3250,1000,2250,26,30.0,1950.0
Cricket 22,3208,1000,2208,30,15.0,4416.0
Cricket 19 (Windows),2983,1070,1913,34,25.5,2550.6666666666665
Creepy Tale: Some Other Place (Windows),1032,1000,32,25,2.0,400.0
Creepy Tale: Ingrid Penance (Windows),1256,1000,256,27,8.0,864.0
Creepy Tale 2,1166,1000,166,15,3.0,830.0
Creepy Tale,1056,1000,56,13,1.0,728.0
Creatures of Ava,3981,1000,2981,27,20.0,4024.35
Creature in the Well,2415,1000,1415,25,6.0,5895.833333333333
Crazy Chicken Kart 2,1291,1000,291,17,3.0,1649.0
Crazy Cats vs. Crazy Cyborgs (Windows),2016,2000,16,16,0.5,512.0
Crazy Athletics - Summer Sports & Games,1494,1000,494,24,2.0,5928.0
Crawlers And Brawlers,1877,1000,877,24,15.0,1403.2
Crate Fang (Windows),2033,2000,33,15,0.5,990.0
Crash Drive 3,2316,1000,1316,53,35.0,1992.8
Crash Bandicoot N. Sane Trilogy,11149,3000,8149,77,40.0,15686.825
Craftopia,3053,1000,2053,28,25.0,2299.36
Crackdown 3: Wrecking Zone,1194,500,694,12,6.0,1388.0
Crackdown 3: Campaign,6531,1750,4781,95,26.5,17139.43396226415
Cozy Designer,2252,2000,252,27,0.5,13608.0
Covenant of Solitude,2448,1000,1448,25,9.0,4022.222222222222
Cosmo Run (Windows),2038,1000,1038,22,25.0,913.44
Cosmic Mirage (Windows),1002,1000,2,10,0.5,40.0
CorpoNation: The Sorting Process,2454,1000,1454,26,65.0,581.6
Core Keeper (Windows),3783,1125,2658,51,84.0,1613.7857142857142
Coral Island,2924,1000,1924,51,341.0,287.75366568914956
Cooking Simulator (Windows),1832,1300,532,33,0.5,35112.0
Control:Override,2272,1000,1272,10,2.0,6360.0
Control (Windows),2037,1000,1037,46,20.0,2385.1
Construction Simulator,5116,1000,4116,33,150.0,905.52
Conan Exiles,2701,1160,1541,28,1.0,43148.0
ComputerHead: Springloaded (Windows),2020,2000,20,15,0.5,600.0
ComputerHead: Recoil (Windows),2035,2000,35,15,0.5,1050.0
Company of Heroes 2: Complete Collection (Windows),2603,1000,1603,11,25.0,705.32
Commandos: Origins,4464,1000,3464,50,82.0,2112.1951219512193
Commandos 3 - HD Remaster,3247,1000,2247,39,20.0,4381.65
CometStriker DX,3038,1000,2038,50,49.0,2079.591836734694
Comanche (Windows),3870,1000,2870,29,117.0,711.3675213675214
Colorful Colore (Windows),4093,4000,93,25,0.5,4650.0
Colorful Boi (Xbox One & Windows),1332,1000,332,33,1.0,10956.0
Collie Call: Farm of Tomorrow (Windows),2041,2000,41,26,0.5,2132.0
Collie Call (Windows),2051,2000,51,26,0.5,2652.0
Cold Silence (Windows),1398,1000,398,11,2.0,2189.0
Cold Alley (Windows),296,200,96,18,15.0,115.2
Coffee Talk Episode 2: Hibiscus and Butterfly,1820,1000,820,53,8.0,5432.5
Coffee Talk,1799,1000,799,24,3.0,6392.0
Cocoon,1455,1000,455,17,4.0,1933.75
Clouds & Sheep 2,1763,1000,763,24,8.0,2289.0
Clone Drone in the Danger Zone,6482,1120,5362,59,41.5,7623.084337349397
Classic Snake Adventures,1258,1000,258,14,3.0,1204.0
Clan N,1473,1000,473,17,2.0,4020.5
Clair Obscur: Expedition 33,1966,1000,966,55,60.0,885.5
City Transport Simulator: Tram,6615,1000,5615,20,69.0,1627.536231884058
Citizen Sleeper 2: Starward Vector,1885,1000,885,30,15.0,1770.0
Citizen Sleeper,1956,1000,956,27,8.0,3226.5
Cities: Skylines II (Windows),3813,1000,2813,36,150.0,675.12
Cities: Skylines,5644,1085,4559,46,152.0,1379.6973684210527
Cipher Monk (Windows),2065,2000,65,23,0.5,2990.0
Cinderscratch (Windows),1014,1000,14,10,0.5,280.0
Cinders,1302,1000,302,13,3.0,1308.6666666666667
Chronus Arc,1248,1000,248,10,15.0,165.33333333333334
Chrome Wolf,1344,1000,344,22,24.0,315.3333333333333
Chroma Quaternion,1459,1000,459,33,15.0,1009.8
Chorus,2780,1000,1780,42,20.0,3738.0
Choo-Choo Charles,1282,1000,282,24,3.0,2256.0
Choice of Life: Middle Ages (Windows),1090,1000,90,19,1.0,1710.0
Chivalry 2,3466,1000,2466,41,40.0,2527.65
Chippy's Stash (Windows),2024,2000,24,26,0.5,1248.0
Chinatown Detective Agency,1698,1000,698,16,8.0,1396.0
Children of Zodiarcs,4025,1000,3025,40,25.0,4840.0
Children of Morta,2431,1000,1431,45,20.0,3219.75
Chicory: A Colorful Tale,3263,1000,2263,33,15.0,4978.6
Chickens Madness,2651,1000,1651,18,25.0,1188.72
Chess Royal,2985,1000,1985,29,20.0,2878.25
Chess Gambit,1444,1000,444,22,15.0,651.2
Cherry Tower (Xbox One & Windows),1158,1000,158,29,0.5,9164.0
Check and Slash (Windows),2109,2000,109,22,0.5,4796.0
Chasm: The Rift,3121,1000,2121,26,12.0,4595.5
Charon's Staircase,1191,1000,191,20,1.0,3820.0
Chants of Sennaar,1520,1000,520,25,8.0,1625.0
Chained Echoes,3027,1000,2027,37,50.0,1499.98
Century: Age of Ashes,7274,1000,6274,33,100.0,2070.42
Cell Scientists: Beyond,3353,1000,2353,19,4.0,11176.75
Celeste,2348,1000,1348,30,8.0,5055.0
Cats with Guns (Windows),2098,2000,98,15,0.5,2940.0
Caterpillar (Windows),4530,4000,530,25,0.5,26500.0
Catacomb Master (Windows),4632,4000,632,25,0.5,31600.0
Cat's Request (Windows),1027,1000,27,23,0.5,1242.0
Cat in Rain (Windows),3175,3000,175,20,0.5,7000.0
Cat and Ghostly Road (Windows),1021,1000,21,21,0.5,882.0
Cat Pipes (Windows),4254,4000,254,40,0.5,20320.0
Castle of no Escape 2 (Windows),4099,4000,99,25,0.5,4950.0
Castle of no Escape (Windows),3048,3000,48,20,0.5,1920.0
Castle Walker (Windows),5656,5000,656,30,0.5,39360.0
Cassette Beasts,2716,1000,1716,100,0.5,343200.0
Carto (Windows),1405,1000,405,20,4.0,2025.0
Carrion (Windows),1966,1000,966,21,6.0,3381.0
Carnage in Space - Ignition,3148,1000,2148,30,8.0,8055.0
Carmen Sandiego,1716,1000,716,10,6.0,1193.3333333333333
Car Mechanic Simulator 2021,3219,1000,2219,46,80.0,1275.925
Capybara Goes to Space (Windows),2155,2000,155,15,0.5,4650.0
Captain Velvet Meteor: The Jump+ Dimensions,3417,1000,2417,40,28.0,3452.8571428571427
Cannibal Cuisine,2285,1000,1285,17,5.0,4369.0
Candivity,1543,1000,543,34,9.0,2051.3333333333335
Call of the Wild: The Angler,5456,1000,4456,30,150.0,891.2
Call of the Sea (Windows),1513,1000,513,34,4.0,4360.5
Call of Toys: Tower Defense!,3221,2000,1221,79,15.0,6430.6
Call of Heroes: Tower Defense,3387,2000,1387,72,20.0,4993.2
Call of Duty: WWII (Windows),4543,1000,3543,50,160.0,1107.1875
Call of Duty: Modern Warfare Remastered (Windows),1240,1000,240,50,6.0,2000.0
Call of Duty: Modern Warfare 3 (2011) (Windows),1576,1000,576,50,52.0,553.8461538461538
Call of Duty: Modern Warfare 2 (2009) (Windows),1405,1000,405,50,15.0,1350.0
Call of Duty: Infinite Warfare (Windows),1498,1000,498,50,20.0,1245.0
Call of Duty: Ghosts (Windows),1453,1000,453,50,59.0,383.89830508474574
Call of Duty: Black Ops III (Windows),2037,1000,1037,47,106.0,459.8018867924528
Call of Duty: Black Ops (Windows),1482,1000,482,50,49.0,491.83673469387753
Call of Duty: Advanced Warfare (Windows),1483,1000,483,50,41.0,589.0243902439024
Call of Duty,9735,3000,6735,1,170.0,39.61764705882353
Cafeteria Nipponica,1318,1000,318,10,25.0,127.2
Cafe Master Story,1664,1000,664,18,17.0,703.0588235294117
CROSSBOW: Bloodnight,1877,1000,877,10,5.0,1754.0
CONSCRIPT,3839,1000,2839,34,56.0,1723.6785714285713
CODE VEIN (Windows),3983,1000,2983,43,40.0,3206.725
Butterfly 2 (Windows),4142,4000,142,25,0.5,7100.0
Butterfly (Windows),4084,4000,84,25,0.5,4200.0
Bus Simulator 21 Next Stop,3465,1000,2465,37,60.0,1520.0833333333333
Burn in Health (Windows),2053,2000,53,15,0.5,1590.0
Buried Alive: Breathless Rescue,1428,1000,428,10,2.0,2140.0
Burger Bistro Story,1657,1000,657,10,15.0,438.0
Bunny Parking (Windows),5520,5000,520,72,2.0,18720.0
Bunny Park,1527,1000,527,18,4.0,2371.5
Bunny Factory,6611,5000,1611,37,5.5,10837.636363636364
Bulwark Evolution: Falconeer Chronicles,2468,1000,1468,24,53.0,664.7547169811321
Bullet Beat (Windows),5183,5000,183,34,0.5,12444.0
Bugsnax,2539,1000,1539,30,15.0,3078.0
Bug Fables: The Everlasting Sapling,2628,1000,1628,30,40.0,1221.0
Buddy Garden (Windows),2020,2000,20,15,0.5,600.0
Brothers in Hell (Windows),1609,1000,609,20,8.0,1522.5
Brotato,2539,1120,1419,91,22.0,5869.5
Broforce,3493,1000,2493,15,1.0,37395.0
Bright Paw: Definitive Edition,1641,1000,641,37,8.0,2964.625
Bridge Race,1182,1000,182,20,2.0,1820.0
Bridge Constructor: The Walking Dead,1946,1000,946,13,5.0,2459.6
Bridge Constructor Portal,2368,1000,1368,16,15.0,1459.2
Breathedge (Windows),4384,1000,3384,45,25.0,6091.2
Bramble: The Mountain King,1717,1000,717,30,8.0,2688.75
Brain Storm: Tower Bombarde (Windows),1000,1000,0,11,0.5,0.0
Boyfriend Dungeon,4180,1400,2780,45,10.0,12510.0
Boxing Gym Story,1786,1000,786,10,40.0,196.5
Boxes Wizard (Windows),2052,2000,52,22,0.5,2288.0
Box Align,1468,1000,468,17,2.0,3978.0
Boundland (Windows),3078,3000,78,20,0.5,3120.0
Bouncy Bread (Windows),2058,2000,58,15,0.5,1740.0
Boulder Dash Deluxe,2704,1000,1704,16,15.0,1817.6
Botany Manor (Windows),1337,1120,217,36,1.0,7812.0
Boss Rush: Mythology (Windows),1000,1000,0,20,0.5,0.0
Borderlands 3 (Windows),7469,2175,5294,81,60.0,7146.9
Boomerforge (Windows),1010,1000,10,10,0.5,200.0
Bool Capture (Windows),2122,2000,122,15,0.5,3660.0
Bonds of the Skies,1242,1000,242,23,8.0,695.75
Bomb Rush Cyberfunk,1939,1000,939,23,15.0,1439.8
Bomb Bowling X (Windows),2059,2000,59,15,0.5,1770.0
Bluey: The Videogame,1583,1000,583,22,2.0,6413.0
Blue Prince,2816,1000,1816,16,60.0,484.26666666666665
Bloons TD 6 (Windows),2165,1000,1165,100,300.0,388.3333333333333
Bloomyth,3211,1000,2211,26,5.0,11497.2
Bloodstained: Ritual of the Night (Windows),2386,1000,1386,45,25.0,2494.8
Bloodshore,1236,1000,236,17,3.0,1337.3333333333333
Bloodroots,2735,1000,1735,33,6.0,9542.5
Block Tower TD 2 (Windows),2020,2000,20,15,0.5,600.0
Block Tower TD (Windows),2210,2000,210,15,0.5,6300.0
Blind Postman (Windows),5273,5000,273,134,0.5,73164.0
Bleeding Edge,2259,1000,1259,10,8.0,1573.75
Blazing Chrome,5724,1000,4724,39,12.0,15353.0
BlazBlue: Cross Tag Battle Special Edition,3398,1000,2398,42,6.0,16786.0
BlazBlue: Calamity Trigger (Windows),268,200,68,10,3.0,226.66666666666666
Blair Witch,4235,1000,3235,25,10.0,8087.5
Blacksmith of the Sand Kingdom,1294,1000,294,45,25.0,529.2
Black Skylands,2122,1000,1122,28,20.0,1570.8
Black Pieces Move First,1740,1000,740,10,6.0,1233.3333333333333
Biz Builder Delux,2195,1000,1195,10,53.0,225.47169811320754
Big Buck Hunter: Ultimate Trophy,1529,1000,529,18,17.0,560.1176470588235
Big Buck Hunter Pro Adventure (Windows),445,200,245,20,15.0,326.6666666666667
Beyond Doors (Windows),2135,2000,135,42,0.5,11340.0
Beyond Border (Windows),2021,2000,21,27,0.5,1134.0
Betomis (Windows),3290,3000,290,22,0.5,12760.0
Bestial Reception (Windows),2267,2000,267,15,0.5,8010.0
Besiege (Windows),3288,1000,2288,36,8.0,10296.0
Ben 10: Power Trip,3378,1000,2378,28,15.0,4438.933333333333
Bejeweled LIVE (Windows),379,200,179,12,8.0,268.5
Before We Leave,10588,1000,9588,55,60.0,8789.0
Bee Flowers: Save the Garden (Windows),2064,2000,64,26,0.5,3328.0
Bee Flowers: Royal Garden (Windows),2031,2000,31,26,0.5,1612.0
Bee Flowers (Windows),2062,2000,62,26,0.5,3224.0
Beautiful Sakura: Volleyball Club (Windows),1000,1000,0,10,0.5,0.0
Beautiful Sakura: Surfing Club (Windows),1000,1000,0,10,0.5,0.0
Beautiful Sakura: Running Club (Windows),1000,1000,0,10,0.5,0.0
Beautiful Sakura: Racing Club (Windows),1000,1000,0,10,0.5,0.0
Beautiful Sakura: Fitness Club (Windows),1000,1000,0,10,0.5,0.0
Beautiful Sakura: Fighting Club (Windows),1000,1000,0,10,0.5,0.0
Beautiful Sakura: Fashion Club (Windows),1000,1000,0,10,0.5,0.0
Beat of Montezuma (Windows),3524,3000,524,20,0.5,20960.0
Beastie Bay DX,1810,1000,810,10,34.0,238.23529411764707
Bear Knight Honey Quest (Windows),2040,2000,40,20,0.5,1600.0
Bear Escape Mission (Windows),2087,2000,87,15,0.5,2610.0
Beacon Pines,1523,1000,523,10,3.0,1743.3333333333333
Bay Breaker (Windows),1016,1000,16,10,0.5,320.0
Battletoads,4007,1000,3007,61,15.0,12228.466666666667
Battleminer Giants,1732,1000,732,15,8.0,1372.5
Batman: The Telltale Series (Windows),228,200,28,6,1.0,168.0
Batman: The Enemy Within - The Telltale Series (Windows),209,200,9,6,1.0,54.0
Bassmaster Fishing,11822,1000,10822,25,120.0,2254.5833333333335
Basketball Pinball,1371,1000,371,15,1.0,5565.0
Barbie Project Friendship,2063,1000,1063,27,6.0,4783.5
Ballotron Oceans (Windows),5452,5000,452,30,0.5,27120.0
Ballotron Galaxy (Windows),3193,3000,193,20,0.5,7720.0
Ballotron Coolbox (Windows),4447,4000,447,25,0.5,22350.0
Ballotron (Windows),3101,3000,101,20,0.5,4040.0
Balatro,5417,1000,4417,31,200.0,684.635
Balan Wonderworld,4305,1000,3305,46,40.0,3800.75
Back to Belt,3491,1000,2491,25,17.0,3663.235294117647
Back 4 Blood,3765,1030,2735,58,150.5,1054.0199335548173
Baby Shark: Sing & Swim Party,1514,1000,514,32,8.0,2056.0
Babel Rising 3D (Windows),452,200,252,12,6.0,504.0
BROK the InvestiGator,3289,1000,2289,29,6.0,11063.5
BREAKING BRICKS (Windows),2092,2000,92,15,1.0,1380.0
BQM - BlockQuest Maker,2385,1000,1385,39,229.0,235.87336244541484
Awesome Pea 3 (Windows),1104,1000,104,24,0.5,4992.0
Awakening the Charge (Windows),1507,1500,7,15,0.5,210.0
Avowed,3154,1000,2154,50,60.0,1795.0
Atomicrops (Windows),2976,1110,1866,26,67.0,724.1194029850747
Atomic Heart,4770,1000,3770,42,40.0,3958.5
Atomfall,2887,1000,1887,36,20.0,3396.6
Atlas Fallen,2693,1000,1693,36,20.0,3047.4
Astrune Academy,1289,1000,289,32,8.0,1156.0
Astroneer,3930,1075,2855,56,62.0,2578.7096774193546
Astrologaster (Windows),1026,1000,26,25,1.0,650.0
Astro Miner,1095,1000,95,21,2.0,997.5
Astria Ascending,5524,1000,4524,50,50.0,4524.0
Astebros,4808,1000,3808,34,30.0,4315.733333333334
Assassin's Creed Pirates (Windows),370,200,170,20,15.0,226.66666666666666
Asphalt Overdrive (Windows),464,200,264,20,8.0,660.0
Asphalt Legends Unite,4343,1000,3343,20,120.0,557.1666666666666
Asphalt 8: Airborne (Windows),455,200,255,20,300.0,17.0
Asphalt 7: Heat (Windows),405,200,205,20,40.0,102.5
Ashen,3230,1000,2230,31,50.0,1382.6
Asdivine Saga,1495,1000,495,34,15.0,1122.0
Asdivine Menace,1524,1000,524,15,12.0,655.0
Asdivine Kamura,1539,1000,539,37,15.0,1329.5333333333333
Asdivine Hearts II,1807,1000,807,34,15.0,1829.2
Asdivine Hearts,2390,1000,1390,15,25.0,834.0
Asdivine Dios,1628,1000,628,20,20.0,628.0
Asdivine Cross,2076,1000,1076,17,40.0,457.3
As Dusk Falls,1686,1000,686,50,12.0,2858.3333333333335
Arsene Lupin - Once A Thief,1234,1000,234,46,10.0,1076.4
Arrowstorm Ascendant (Windows),3283,3000,283,20,1.0,5660.0
Arrest of a stone Buddha,3737,2000,1737,18,7.0,4466.571428571428
Armed Emeth,1536,1000,536,26,15.0,929.0666666666667
Arkham Horror: Mother's Embrace,2332,1000,1332,20,10.0,2664.0
Arkanoid Eternal Battle,7196,1000,6196,23,27.0,5278.074074074074
Archvale,1946,1000,946,40,8.0,4730.0
Arcadia Fallen,1801,1000,801,17,28.0,486.32142857142856
Arcade Paradise,3810,1000,2810,54,40.0,3793.5
Aragami 2,3998,1000,2998,44,20.0,6595.6
Ara: History Untold,10061,1000,9061,45,52.0,7841.25
Aquarun (Windows),2028,2000,28,25,0.5,1400.0
Apollo Justice: Ace Attorney Trilogy,1711,1000,711,32,60.0,379.2
Anuchard,1916,1000,916,18,6.0,2748.0
Antiquia Lost,1799,1000,799,34,15.0,1811.0666666666666
AntVentor,1055,1000,55,11,0.5,1210.0
Another Dawn,1221,1000,221,10,1.0,2210.0
Another Crab's Treasure,3795,1300,2495,38,16.0,5925.625
Ankora: Lost Days,1434,1000,434,23,12.0,831.8333333333334
Animus - Stand Alone,1896,1000,896,13,15.0,776.5333333333333
Anime Studio Story,1461,1000,461,10,12.0,384.1666666666667
Animated Puzzles Star (Windows),1815,1000,815,14,15.0,760.6666666666666
Angry Birds Star Wars (Windows),315,200,115,20,25.0,92.0
Angry Birds Space (Windows),389,200,189,20,30.0,126.0
Andromeda Survivors (Windows),3127,3000,127,31,0.5,7874.0
Ancient Phantasma,1499,1000,499,22,12.0,914.8333333333334
Ancient Ants Adventure (Windows),3076,3000,76,20,0.5,3040.0
Among Us,3599,1180,2419,33,10.0,7982.7
Amnesia: The Bunker,3329,1040,2289,44,8.0,12589.5
Amnesia: Rebirth,3230,1000,2230,41,12.0,7619.166666666667
Amnesia: Collection (Windows),2724,1000,1724,22,15.0,2528.5333333333333
Amerzone - The Explorer's Legacy,1525,1000,525,29,8.0,1903.125
Ambition Record,1620,1000,620,32,15.0,1322.6666666666667
Amazing Maze,2288,2000,288,17,1.0,4896.0
Amazing Cultivation Simulator (Windows),5240,1000,4240,10,24.0,1766.6666666666667
Alvastia Chronicles,2707,1000,1707,31,15.0,3527.8
Alto's Adventure (Windows),4636,1000,3636,20,300.0,242.4
Alter Age,1373,1000,373,32,18.0,663.1111111111111
Alphadia Neo,1343,1000,343,32,10.0,1097.6
Alphadia I & II,1552,1000,552,35,25.0,772.8
Alphadia Genesis 2,1571,1000,571,19,15.0,723.2666666666667
Alphadia Genesis,1596,1000,596,33,20.0,983.4
AlphaJax (Windows),304,200,104,20,3.0,693.3333333333334
Alpacapaca Dash 2 (Windows),2057,2000,57,15,0.5,1710.0
Alpacapaca Dash (Windows),3150,3000,150,20,0.5,6000.0
Allison's Diary: Rebirth,1121,1000,121,11,1.0,1331.0
All You Need Is Help,5622,1000,4622,31,12.0,11940.166666666666
Aliens: Fireteam Elite,5240,1050,4190,43,102.0,1766.3725490196077
Aliens: Dark Descent,3236,1000,2236,45,50.0,2012.4
Alien: Isolation (Windows),3383,1000,2383,50,15.0,7943.333333333333
Alien Cat Story (Windows),1010,1000,10,10,0.5,200.0
Alfred Hitchcock - Vertigo,1320,1000,320,31,8.0,1240.0
Alder's Blood: Definitive Edition,2746,1000,1746,57,27.0,3686.0
Alchemist Simulator,1774,1000,774,12,6.0,1548.0
Akinakes (Windows),2030,2000,30,15,0.5,900.0
Akatsuki: Lord of the Dawn (Windows),1450,1000,450,33,20.0,742.5
Akane,3216,1000,2216,35,6.0,12926.666666666666
Airoheart,2434,1000,1434,29,20.0,2079.3
Aircraft RC-2 (Windows),2565,1000,1565,32,11.0,4552.727272727273
Airborne Kingdom,2916,1200,1716,30,16.0,3217.5
"Ah, Love! Season 2 (Windows)",1000,1000,0,40,2.0,0.0
"Ah, Love! (Windows)",2283,2000,283,51,0.5,28866.0
Agriculture (Windows),3480,3000,480,22,2.0,5280.0
Age of Wonders: Planetfall (Windows),4730,1030,3700,52,74.0,2600.0
Age of Wonders 4 (Windows),2728,1000,1728,44,320.0,237.6
Age of Sparta (Windows),313,200,113,20,40.0,56.5
Age of Mythology: Retold,4784,1105,3679,62,45.0,5068.844444444445
Age of Empires: Definitive Edition (Windows),1933,1250,683,44,2.0,15026.0
Age of Empires: Definitive Edition (2018) (Windows),2022,1250,772,44,4.0,8492.0
Age of Empires: Castle Siege (Windows),507,200,307,20,200.0,30.7
Age of Empires: Castle Siege (UWP),2468,1000,1468,20,150.0,195.73333333333332
Age of Empires IV: Anniversary Edition,9644,1310,8334,109,95.0,9562.168421052631
Age of Empires III: Definitive Edition (Windows),3538,1000,2538,42,8.0,13324.5
Age of Empires II: Definitive Edition,9924,1450,8474,156,192.0,6885.125
Agatha Christie - Murder on the Orient Express,1457,1000,457,27,12.0,1028.25
Agatha Christie - Hercule Poirot: The London Case,1080,1000,80,46,6.0,613.3333333333334
Against the Storm,4076,1000,3076,59,200.0,907.42
AeternoBlade,2860,1000,1860,14,25.0,1041.6
Adventures of Bertram Fiddle 2: A Bleaker Predicklement,1074,1000,74,10,2.0,370.0
Adventures of Bertram Fiddle 1: A Dreadly Business,1092,1000,92,10,1.0,920.0
Adios,1160,1000,160,25,1.0,4000.0
Adera (Windows),268,200,68,18,1.0,1224.0
Ace Attorney Investigations Collection,1463,1000,463,30,60.0,231.5
Abyss (Windows),410,200,210,20,3.0,1400.0
Absolute Drift: Zen Edition,1761,1000,761,20,8.0,1902.5
ASTROSMASH,1298,1000,298,10,2.0,1490.0
ASMR Slicing,1048,1000,48,18,0.5,1728.0
ARK: Survival Evolved,3511,1500,2011,33,2.0,33181.5
ARK: Survival Ascended,2679,1000,1679,31,1.0,52049.0
ANVIL: Vault Breaker,4378,1000,3378,95,181.0,1772.9834254143645
ANNO: Mutationem,2796,1000,1796,36,20.0,3232.8
ANNIE:Last Hope,1640,1000,640,22,5.0,2816.0
AMAZE!,1380,1000,380,17,1.0,6460.0
AI: The Somnium Files - nirvanA Initiative,1341,1000,341,49,30.0,556.9666666666667
AI: The Somnium Files,1916,1000,916,45,20.0,2061.0
ACA NEOGEO ZUPAPA! (Windows),1145,1000,145,12,2.0,870.0
ACA NEOGEO ZED BLADE (Windows),1040,1000,40,12,1.0,480.0
ACA NEOGEO WORLD HEROES PERFECT (Windows),1010,1000,10,12,0.5,240.0
ACA NEOGEO WORLD HEROES 2 JET (Windows),1052,1000,52,12,1.0,624.0
ACA NEOGEO WORLD HEROES 2 (Windows),1032,1000,32,12,1.0,384.0
ACA NEOGEO WORLD HEROES (Windows),1002,1000,2,12,0.5,48.0
ACA NEOGEO WAKU WAKU 7 (Windows),1053,1000,53,12,1.0,636.0
ACA NEOGEO TWINKLE STAR SPRITES (Windows),1006,1000,6,12,1.0,72.0
ACA NEOGEO TOP PLAYER'S GOLF (Windows),1190,1000,190,12,2.0,1140.0
ACA NEOGEO TOP HUNTER: RODDY & CATHY (Windows),1104,1000,104,12,1.0,1248.0
ACA NEOGEO THRASH RALLY (Windows),1189,1000,189,12,2.0,1134.0
ACA NEOGEO THE ULTIMATE 11: SNK FOOTBALL CHAMPIONSHIP (Windows),1023,1000,23,12,1.0,276.0
ACA NEOGEO THE SUPER SPY (Windows),1060,1000,60,12,1.0,720.0
ACA NEOGEO THE LAST BLADE 2 (Windows),1022,1000,22,12,0.5,528.0
ACA NEOGEO THE LAST BLADE (Windows),1010,1000,10,12,0.5,240.0
ACA NEOGEO THE KING OF FIGHTERS 2003 (Windows),1017,1000,17,12,0.5,408.0
ACA NEOGEO THE KING OF FIGHTERS 2002 (Windows),1025,1000,25,12,1.0,300.0
ACA NEOGEO THE KING OF FIGHTERS 2001 (Windows),1041,1000,41,12,0.5,984.0
ACA NEOGEO THE KING OF FIGHTERS 2000 (Windows),1017,1000,17,12,0.5,408.0
ACA NEOGEO THE KING OF FIGHTERS '99 (Windows),1025,1000,25,12,1.0,300.0
ACA NEOGEO THE KING OF FIGHTERS '98 (Windows),1064,1000,64,12,1.0,768.0
ACA NEOGEO THE KING OF FIGHTERS '97 (Windows),1028,1000,28,12,1.0,336.0
ACA NEOGEO THE KING OF FIGHTERS '96 (Windows),1007,1000,7,12,0.5,168.0
ACA NEOGEO THE KING OF FIGHTERS '95 (Windows),1020,1000,20,12,1.0,240.0
ACA NEOGEO THE KING OF FIGHTERS '94 (Windows),1039,1000,39,12,1.0,468.0
ACA NEOGEO SUPER SIDEKICKS 3: THE NEXT GLORY (Windows),1022,1000,22,12,1.0,264.0
ACA NEOGEO SUPER SIDEKICKS 2 (Windows),1031,1000,31,12,1.0,372.0
ACA NEOGEO SUPER SIDEKICKS (Windows),1056,1000,56,12,1.0,672.0
ACA NEOGEO STRIKERS 1945 PLUS (Windows),1167,1000,167,12,1.0,2004.0
ACA NEOGEO STREET HOOP (Windows),1046,1000,46,12,1.0,552.0
ACA NEOGEO STAKES WINNER 2 (Windows),1110,1000,110,12,1.0,1320.0
ACA NEOGEO STAKES WINNER (Windows),1132,1000,132,12,2.0,792.0
ACA NEOGEO SPIN MASTER (Windows),1065,1000,65,12,1.0,780.0
ACA NEOGEO SOCCER BRAWL (Windows),1071,1000,71,12,1.0,852.0
ACA NEOGEO SHOCK TROOPERS 2nd Squad (Windows),1113,1000,113,12,1.0,1356.0
ACA NEOGEO SHOCK TROOPERS (Windows),1040,1000,40,12,0.5,960.0
ACA NEOGEO SENGOKU 3 (Windows),1207,1000,207,12,2.0,1242.0
ACA NEOGEO SENGOKU 2 (Windows),1025,1000,25,12,1.0,300.0
ACA NEOGEO SENGOKU (Windows),1125,1000,125,12,1.0,1500.0
ACA NEOGEO SAVAGE REIGN (Windows),1059,1000,59,12,1.0,708.0
ACA NEOGEO SAMURAI SHODOWN V SPECIAL (Windows),1026,1000,26,12,1.0,312.0
ACA NEOGEO SAMURAI SHODOWN V (Windows),1041,1000,41,12,1.0,492.0
ACA NEOGEO SAMURAI SHODOWN IV (Windows),1038,1000,38,12,1.0,456.0
ACA NEOGEO SAMURAI SHODOWN III (Windows),1038,1000,38,12,1.0,456.0
ACA NEOGEO SAMURAI SHODOWN II (Windows),1009,1000,9,12,0.5,216.0
ACA NEOGEO SAMURAI SHODOWN (Windows),1030,1000,30,12,0.5,720.0
ACA NEOGEO ROBO ARMY (Windows),1063,1000,63,12,1.0,756.0
ACA NEOGEO RIDING HERO (Windows),1154,1000,154,12,2.0,924.0
ACA NEOGEO REAL BOUT FATAL FURY SPECIAL (Windows),1010,1000,10,12,0.5,240.0
ACA NEOGEO REAL BOUT FATAL FURY 2 (Windows),1085,1000,85,12,1.0,1020.0
ACA NEOGEO REAL BOUT FATAL FURY (Windows),1057,1000,57,12,1.0,684.0
ACA NEOGEO RAGNAGARD (Windows),1040,1000,40,12,1.0,480.0
ACA NEOGEO PUZZLED (Windows),1374,1000,374,12,5.0,897.6
ACA NEOGEO PUZZLE BOBBLE 2 (Windows),1074,1000,74,12,1.0,888.0
ACA NEOGEO PUZZLE BOBBLE (Windows),1072,1000,72,12,1.0,864.0
ACA NEOGEO PULSTAR (Windows),1114,1000,114,12,2.0,684.0
ACA NEOGEO PREHISTORIC ISLE 2 (Windows),1133,1000,133,12,1.0,1596.0
ACA NEOGEO POWER SPIKES II (Windows),1035,1000,35,12,1.0,420.0
ACA NEOGEO PLEASURE GOAL: 5 ON 5 MINI SOCCER (Windows),1020,1000,20,12,1.0,240.0
ACA NEOGEO OVER TOP (Windows),1037,1000,37,12,1.0,444.0
ACA NEOGEO NINJA MASTER'S (Windows),1041,1000,41,12,0.5,984.0
ACA NEOGEO NINJA COMMANDO (Windows),1061,1000,61,12,1.0,732.0
ACA NEOGEO NINJA COMBAT (Windows),1122,1000,122,12,1.0,1464.0
ACA NEOGEO NEO GEO CUP '98: THE ROAD TO THE VICTORY (Windows),1007,1000,7,12,1.0,84.0
ACA NEOGEO NAM-1975 (Windows),1085,1000,85,12,1.0,1020.0
ACA NEOGEO Money Puzzle Exchanger (Windows),1199,1000,199,12,1.0,2388.0
ACA NEOGEO MUTATION NATION (Windows),1127,1000,127,12,2.0,762.0
ACA NEOGEO METAL SLUG X (Windows),1506,1000,506,12,1.0,6072.0
ACA NEOGEO METAL SLUG 5 (Windows),1141,1000,141,12,1.0,1692.0
ACA NEOGEO METAL SLUG 4 (Windows),1238,1000,238,12,3.0,952.0
ACA NEOGEO METAL SLUG 3 (Windows),1089,1000,89,12,1.0,1068.0
ACA NEOGEO METAL SLUG 2 (Windows),1053,1000,53,12,1.0,636.0
ACA NEOGEO METAL SLUG (Windows),1039,1000,39,12,1.0,468.0
ACA NEOGEO MAGICIAN LORD (Windows),1074,1000,74,12,1.0,888.0
ACA NEOGEO MAGICAL DROP III (Windows),1044,1000,44,12,0.5,1056.0
ACA NEOGEO MAGICAL DROP II (Windows),1106,1000,106,12,2.0,636.0
ACA NEOGEO LEAGUE BOWLING (Windows),1066,1000,66,12,1.0,792.0
ACA NEOGEO LAST RESORT (Windows),1092,1000,92,12,1.0,1104.0
ACA NEOGEO KIZUNA ENCOUNTER (Windows),1018,1000,18,12,0.5,432.0
ACA NEOGEO KING OF THE MONSTERS 2 (Windows),1121,1000,121,12,3.0,484.0
ACA NEOGEO KING OF THE MONSTERS (Windows),1238,1000,238,12,2.0,1428.0
ACA NEOGEO KARNOV'S REVENGE (Windows),1113,1000,113,12,1.0,1356.0
ACA NEOGEO Gururin (Windows),1074,1000,74,12,1.0,888.0
ACA NEOGEO GHOST PILOTS (Windows),1168,1000,168,12,1.0,2016.0
ACA NEOGEO GAROU: MARK OF THE WOLVES (Windows),1016,1000,16,12,0.5,384.0
ACA NEOGEO GALAXY FIGHT: UNIVERSAL WARRIORS (Windows),1022,1000,22,12,0.5,528.0
ACA NEOGEO FOOTBALL FRENZY (Windows),1016,1000,16,12,1.0,192.0
ACA NEOGEO FATAL FURY SPECIAL (Windows),1074,1000,74,12,1.0,888.0
ACA NEOGEO FATAL FURY 3 (Windows),1010,1000,10,12,1.0,120.0
ACA NEOGEO FATAL FURY 2 (Windows),1010,1000,10,12,1.0,120.0
ACA NEOGEO FATAL FURY (Windows),1045,1000,45,12,1.0,540.0
ACA NEOGEO CYBER-LIP (Windows),1181,1000,181,12,2.0,1086.0
ACA NEOGEO CROSSED SWORDS (Windows),1295,1000,295,12,3.0,1180.0
ACA NEOGEO BURNING FIGHT (Windows),1023,1000,23,12,1.0,276.0
ACA NEOGEO BLUE'S JOURNEY (Windows),1028,1000,28,12,1.0,336.0
ACA NEOGEO BLAZING STAR (Windows),1171,1000,171,12,3.0,684.0
ACA NEOGEO BIG TOURNAMENT GOLF (Windows),1105,1000,105,12,2.0,630.0
ACA NEOGEO BASEBALL STARS PROFESSIONAL (Windows),1032,1000,32,12,1.0,384.0
ACA NEOGEO BASEBALL STARS 2 (Windows),1040,1000,40,12,1.0,480.0
ACA NEOGEO ART OF FIGHTING 3 (Windows),1020,1000,20,12,1.0,240.0
ACA NEOGEO ART OF FIGHTING 2 (Windows),1027,1000,27,12,0.5,648.0
ACA NEOGEO ART OF FIGHTING (Windows),1045,1000,45,12,1.0,540.0
ACA NEOGEO ALPHA MISSION II (Windows),1092,1000,92,12,1.0,1104.0
ACA NEOGEO AGGRESSORS OF DARK KOMBAT (Windows),1079,1000,79,12,1.0,948.0
ACA NEOGEO AERO FIGHTERS 3 (Windows),1025,1000,25,12,1.0,300.0
ACA NEOGEO AERO FIGHTERS 2 (Windows),1030,1000,30,12,1.0,360.0
ACA NEOGEO 3 COUNT BOUT (Windows),1056,1000,56,12,1.0,672.0
ACA NEOGEO 2020 SUPER BASEBALL (Windows),1046,1000,46,12,1.0,552.0
ABZ√õ (Windows),1206,1000,206,12,1.0,2472.0
A World of Keflings (Windows),283,200,83,20,8.0,207.5
A Walk in the Dark,2649,1000,1649,27,6.0,7420.5
A Time Traveller's Guide To Past Delicacies (Windows),1016,1000,16,11,0.5,352.0
A Tale of Paper: Refolded,1444,1000,444,29,2.0,6438.0
A Short Hike,1417,1000,417,12,4.0,1251.0
A Plague Tale: Requiem,2115,1000,1115,35,20.0,1951.25
A Plague Tale: Innocence (Windows),1877,1000,877,35,12.0,2557.9166666666665
A Place for the Unwilling,3960,1000,2960,32,172.0,550.6976744186046
A Memoir Blue,1151,1000,151,15,1.0,2265.0
A Little to the Left,2135,1000,1135,47,15.0,3556.3333333333335
9Ball Pocket,1926,1000,926,15,4.0,3472.5
90'' Soccer,1214,1000,214,14,2.0,1498.0
80's OVERDRIVE,2309,1000,1309,65,8.0,10635.625
8-Bit Farm,2093,1000,1093,10,40.0,273.25
8-Ball Pocket,4234,1000,3234,15,15.0,3234.0
7 Days to Die (Windows),2919,1000,1919,43,25.0,3300.68
50 Years (Windows),4100,4000,100,25,0.5,5000.0
4 Elements II: Special Edition (Windows),305,200,105,20,30.0,70.0
3¬∞C: Sand Puzzle,1456,1000,456,10,5.0,912.0
3on3 FreeStyle,8981,1000,7981,34,100.0,2713.54
3D Don't Die Mr. Robot,2966,2000,966,47,10.0,4540.2
30 Birds,2168,1000,1168,30,9.0,3893.3333333333335
2020: My Country (Windows),1309,1000,309,10,20.0,154.5
2 Synchro Hedgehogs (Windows),3046,3000,46,20,0.5,1840.0
1f y0u're a gh0st ca11 me here!,1529,1000,529,33,4.0,4364.25
15in1 Solitaire,1879,1000,879,37,40.0,813.075
1-Bit Dungeon (Windows),2092,2000,92,25,0.5,4600.0
1 Square (Windows),3130,3000,130,45,0.5,11700.0
'n Verlore Verstand,3766,1000,2766,51,12.0,11755.5
#IDARB,1469,1000,469,12,1.0,5628.0
